Wwf, Wwf, Wwf^Es, Aa, Re, Aa, Hhd, Hhd, Hhd^Fp, Mm, Mm^Xm, Mm, Mm^Xm, Mm^Xm, Cfr, Mm, Mm^Xm, Mm^Xm, Mm, Mm, Mm, Mm, Mm, Mm, Mm^Xm, Mm, Mm^Xm, Mm, Mm^Xm, Mm, Mm^Xm, Mm^Xm, Mm^Xm, Mm^Xm, Mm^Xm, Mm^Xm, Mm^Xm, Mm, Mm^Xm, Mm, Mm^Xm, Mm, Mm^Xm, Mm, Mm^Xm, Mm^Xm
Rd, Wwf, Wwf^Es, Wwf^Es, Gll^Fmw, Ha, Ha, Ha^Fp, Ha^Fp, Mm, Mm^Xm, Mm^Xm, Mm^Xm, Cfr, Cfr, Cfr, Mm^Xm, Mm^Xm, Mm, Mm^Xm, Mm, Mm, Hhd^Fp, Mm^Xm, Mm, Mm^Xm, Mm, Mm^Xm, Mm, Mm^Xm, Mm^Xm, Mm^Xm, Mm^Xm, Mm^Xm, Mm^Xm, Mm^Xm, Mm^Xm, Mm^Xm, Mm^Xm, Mm^Xm, Mm^Xm, Mm^Xm, Mm^Xm, Mm^Xm, Mm^Xm, Mm^Xm
Rd, Rd, Rd, Wwf^Es, Wwf^Es, Aa, Aa^Fpa, Aa^Fpa, Aa^Vha, Ha, Isa, Mm^Xm, Cfr, Mm, Isa, Mm, Cfr, Hhd^Fp, Mm, Mm, Mm, Hhd^Fp, Hhd^Fp, Hhd, Mm^Xm, Mm, Hhd^Fp, Mm, Mm, Mm, Mm, Mm^Xm, Mm^Xm, Mm^Xm, Ha^Vhha, Mm, Mm, Mm^Xm, Mm^Xm, Mm^Xm, Cfa, Mm^Xm, Mm^Xm, Mm^Xm, Mm^Xm, Mm^Xm
Aa, Rd, Aa^Vha, Rd, Wwf^Es, Wwf, Ai, Ai, Ai, Isa, Isa, Hhd^Edb, Isa, Isa, Isa, Isa, Hhd, Isa, Mm, Mm^Xm, Mm, Hhd^Fp, Mm, Mm, Mm, Mm^Xm, Mm^Xm, Mm, Mm, Mm, Mm, Mm^Xm, Mm, Mm, Mm, Mm, Cfa, Uu^Vud, Mm, Cfa, 2 Kfa, Cfa, Mm^Xm, Mm^Xm, Mm^Xm, Mm^Xm
Aa, Aa^Fpa, Aa^Fpa, Aa, Wwf, Wwf, Gll^Fmw, Ai, Ai, Ai, Wwf^Es, Ha, Wwf, Ha^Fp, Wwf^Edb, Wwf^Edb, Wwf, Isa, Isa, Mm, Hhd, Mm, Hhd^Fp, Hhd, Hhd^Fp, Mm, Mm, Mm, Hhd, Mm, Mm^Xm, Mm, Mm, Mm, Hhd, Hhd, Mm, Mm, Mm, Cfa, Cfa, Cfa, Mm^Xm, Mm^Xm, Mm^Xm, Mm^Xm
Re, Rd, Gll^Fmw, Rd, Re, Wwf, Wwf, Wwf, Wwf, Wwf^Es, Wwf, Wwf, Wwf, Wwf, Wwf, Wwf, Aa^Fp, Re, Re, Ha, Ha, Hhd, Ha, Ha^Fp, Ha^Fp, Ha, Ha, Hhd, Hhd, Mm, Mm, Mm, Mm, Mm, Mm, Mm, Mm, Mm, Mm, Mm, Mm, Mm, Ha^Vhha, Mm^Xm, Hhd^Fp, Mm^Xm
Gll^Fmw, Gll^Fmw, Gll^Fmw, Gd^Efm, Re, Qxu, Qxu, Qxu, Hhd^Efm, Hhd^Fmw, Hhd^Fmw, Hhd^Fmw, Wwf, Ai, Aa^Fpa, Aa^Fpa, Aa^Fpa, Aa, Re, Re, Gll^Efm, Re, Re, Aa^Fp, Aa^Fp, Ha, Re, Re, Hhd, Hhd, Hhd^Fp, Mm, Mm, Mm, Hhd, Mm, Mm, Cfa, Mm, Mm, Mm, Mm, Mm, Mm^Xm, Mm, Hhd^Fp
Aa^Fpa, Aa^Fpa, Aa^Fp, Hhd^Fmw, Hhd^Fmw, Re, Rd, Gll^Efm, Rd, Aa, Aa, Hhd^Fmw, Wwf^Es, Wwf, Qxu, Aa^Fpa, Gll^Fmw, Re, Aa^Fpa, Gll^Fmw, Gll^Efm, Re, Aa, Aa^Fpa, Aa, Ha, Re, Re, Re, Hhd^Fp, Hhd^Fp, Hhd, Mm, Mm^Xm, Mm, Mm, Hhd, Mm, Mm, Mm, Mm, Cfa, Mm, Hhd^Fp, Hhd^Fp, Mm
Re, Aa^Fpa, Aa^Fpa, Aa^Fp, Hhd^Fmw, Rd, Aa^Fpa, Rd, Aa, Rd, Rd, Wwf^Es, Wwf, Qxu, Qxu, Gll^Fp, Gll^Fp, Aa, Aa^Fpa, Aa^Fpa, Gll^Fmw, Re, Gll, Rd, Hhd^Fmw, Re, Aa^Fpa, Gd^Efm, Gd^Efm, Hhd^Fp, Hhd, Hhd, Hhd, Mm, Mm, Mm, Mm, Hhd, Mm, Mm, Mm, Mm, Mm, Mm^Xm, Mm^Xm, Mm
Re, Aa^Fpa, Aa^Fpa, Aa^Fpa, Rd, Rd, Rd, Rd, Aa^Fpa, Aa^Fpa, Aa^Fpa, Wwf, Wwf^Es, Gll^Fmw, Gll, Gll^Fmw, Aa, Aa, Aa^Fpa, Aa^Fpa, Hhd^Fp, Hhd^Fmw, Aa, Rd, Hhd^Fmw, Hhd^Fmw, Aa^Fpa, Aa^Fpa, Aa^Vha, Hhd, Gd^Efm, Gd^Efm, Hhd, Mm, Mm, Mm, Mm, Hhd, Hhd, Mm, Hhd, Mm, Mm, Mm^Xm, Mm, Mm
Gll^Fmw, Gll^Fmw, Re, Re, Re^Edb, Rd^Edb, Aa, Aa^Vha, Aa, Aa^Fpa, Gd^Efm, Rd, Gll, Wwf^Es, Wwf^Es, Gll^Efm, Gll^Fmw, Aa, Aa, Gll^Fp, Hhd^Fp, Hhd^Fp, Hhd, Aa, Rd, Aa, Aa^Fpa, Gd^Efm, Gd^Efm, Gd^Efm, Re, Gd^Efm, Hhd, Mm, Mm, Mm, Hhd, Hhd, Hhd^Fp, Hhd^Fp, Hhd^Fp, Hhd, Mm^Fp, Mm^Xm, Mm, Mm
Aa, Re, Aa, Aa, Re, Re, Re, Rd, Hhd^Fmw, Hhd^Fmw, Hhd^Fmw, Gd^Efm, Gll^Fmw, Gll^Fmw, Wwf^Es, Wwf, Gll, Gll^Efm, Aa^Vha, Aa^Fpa, Gll^Fp, Aa, Aa, Rd, 3 Aa, Rd, Rd, Gd^Efm, Hhd^Fmw, Hhd^Fmw, Re, Gd^Efm, Hhd, Hhd, Hhd, Mm, Ha, Hhd, Hhd, Hhd, Hhd, Hhd^Fp, Hhd^Fp, Mm, Hhd^Fp, Mm
Ha, Ha, Ha, Ha, Hhd, Hhd, Hhd, Gll^Fmw, Hhd, Gd^Efm, Gd^Efm, Rd, Rd, Gll^Fmw, Rd, Wwf, Wwf, Wwf, Wwf^Es, Aa, Aa, Hhd^Fp, Gll, Rd, Wwf, Rd, Rd, Rd, Hhd^Fmw, Hhd^Fp, Hhd^Fp, Gd^Efm, Gd^Efm, Hhd, Aa, Hhd, Ha, Ha, Gd^Efm, Gd^Efm, Re, Re, Hhd^Fp, Hhd^Fp, Hhd^Fp, Hhd
Hhd, Ha, Mm, Hhd, Mm, Mm, Re, Re, Re, Re, Aa, Rd, Gll^Fmw, Rd, Aa^Fpa, Wwf, Aa^Fpa, Rd, Wwf^Es, Wwf, Aa, Gll, Wwf^Es, Wwf^Es, Wwf, Wwf, Wwf, Rd, Wwf, Qxu, Qxu, Qxu, Qxu, Aa, Aa, Aa, Hhd, Hhd^Efm, Gll, Re, Rd, Aa, Re, Re^Fp, Gd^Fp, Rd
Hhd, Mm^Xm, Mm, Mm, Mm^Xm, Mm, Mm, Hhd, Aa^Fpa, Aa^Fpa, Aa, Gll^Fmw, Hhd^Fp, Gll^Fmw, Gll^Fmw, Aa^Fpa, Gll^Fmw, Rd, Rd, Wwf, Wwf, Gll, Wwf, Wwf, Wwf, Aa^Fpa, Wwf, Wwf^Es, Wwf^Es, Qxu, Wwf^Es, Wwf, Wwf, Wwf, Rd, Aa, Rd, Hhd, Gll^Fmw, Re, Aa, Aa, Re, Gll^Fp, Gd^Fp, Aa
Mm, Hhd^Fp, Mm^Xm, Mm^Xm, Mm^Xm, Mm, Hhd^Fpa, Hhd, Hhd, Aa, Hhd^Fp, Hhd^Fp, Hhd, Gll^Fmw, Hhd^Fp, Hhd, Hhd, Gll^Fmw, Gll^Fmw, Gll^Fmw, Re, Wwf, Aa^Fpa, Aa^Fpa, Aa^Fpa, Wwf, Rd, Rd, Wwf, Wwf^Es, Wwf^Es, Wwf, Wwf, Wwf, Wwf, Rd, Aa^Fpa, Aa^Fpa, Aa^Fpa, Aa, Aa, Rd, Ai, Gd^Fp, Aa, Aa
Mm, Mm^Xm, Mm^Xm, Mm, Mm^Xm, Mm, Mm, Hhd^Fpa, Cfa, Hhd, Rd, Hhd, Hhd, Hhd^Fp, Hhd, Hhd, Hhd, Hhd, Hhd, Hhd, Hhd, Hhd, Aa^Fda, Aa^Fpa, Aa^Fpa, Rd, Rd, Rd, Gll, Wwf, Rd, Aa, Aa, Aa^Fpa, Wwf^Es, Gll^Fmw, Aa^Fpa, Aa^Fpa, Hhd^Fp, Aa^Fpa, Aa, Ai, Re, Aa, Aa^Vha, Aa
Mm^Xm, Mm^Xm, Mm^Xm, Mm^Xm, Mm, Mm^Xm, Ha^Vhha, Hhd^Fpa, Re, Hhd^Fpa, Re, Mm^Xm, Mm^Xm, Mm, Hhd, Hhd, Mm^Xm, Hhd, Hhd, Gll^Fmw, Re, Aa, Re, Aa, Re, Re, Gll^Efm, Gll^Efm, Hhd^Fmw, Gll^Efm, Hhd, Hhd, Aa, Wwf, Wwf, Wwf^Es, Rd, Hhd^Fp, Gll^Fp, Aa^Fpa, Ai, Ai, Ai, Re, Aa, Aa
Mm^Xm, Mm^Xm, Mm^Xm, Mm, Mm, Mm, Mm, Rd, Cfa, Hhd, Hhd, Cfa, Mm, Mm, Hhd, Mm^Xm, Mm^Xm, Mm, Gll^Fmw, Gll^Fmw, Hhd, Re, Re, Re, Re, Re, Gll, Gll^Efm, Aa^Fpa, Aa^Fpa, Hhd^Fmw, Hhd, Rd, Qxu, Wwf, Wwf^Es, Wwf, Aa^Fpa, Gll^Fmw, Ai, Ai, Ai, Ai, Ai, Ai, Aa
Mm^Xm, Mm^Xm, Mm, Mm, Uu^Vud, Mm, Mm, Cfa, 4 Kfa, 1 Cfa, Cfa, Hhd, Hhd, Hhd, Mm, Mm, Mm^Xm, Gll^Fmw, Gll^Fmw, Hhd, Hhd, Hhd, Hhd, Hhd, Ha, Aa, Aa, Aa^Fpa, Aa, Aa^Fpa, Aa^Fpa, Hhd^Efm, Hhd^Fmw, Qxu, Qxu, Wwf^Es, Wwf^Es, Wwf, Aa^Fpa, Ai, Ai, Ai, Ai, Ai, Ai, Aa
Mm^Xm, Mm^Xm, Mm^Xm, Mm, Mm, Mm, Mm, Cfa, Cfa, Cfa, Kfa, Mm, Cfa, Mm, Mm, Ha^Vhha, Mm^Xm, Mm, Mm, Mm, Hhd, Hhd, Hhd, Hhd, Ha, Aa, Ha, Ha, Ha^Fp, Aa, Gll^Fmw, Hhd^Fp, Hhd^Fp, Hhd^Fmw, Hhd^Fp, Wwf, Wwf, Rd, Aa^Fpa, Aa, Ai, Ai, Ai, Ai, Aa, Aa
Mm^Xm, Mm^Xm, Mm^Xm, Mm^Xm, Mm^Xm, Mm^Xm, Mm^Xm, Mm^Xm, Mm, Mm, Mm, Mm, Mm, Mm, Mm, Mm^Xm, Mm^Xm, Mm^Xm, Mm^Xm, Mm, Mm, Mm, Mm, Hhd, Hhd, Ha^Fp, Mm, Ha, Ha^Fp, Ha^Fp, Aa^Fp, Re^Fp, Aa, Gll^Fp, Gll^Fp, Gll^Fmw, Wwf, Ai, Ai, Ai, Ai^Es, Ai^Es, Aa^Vca, Ai, Ai, Aa
Mm^Xm, Mm^Xm, Mm^Xm, Mm^Xm, Mm^Xm, Mm^Xm, Mm^Xm, Mm^Xm, Mm^Xm, Mm, Mm^Xm, Mm, Mm^Xm, Mm, Mm^Xm, Mm^Xm, Mm, Mm, Mm, Mm, Mm, Hhd^Fp, Mm, Mm, Mm, Mm, Mm, Mm, Ha, Ha, Aa, Aa^Vha, Aa, Aa, Aa, Re, Wwf, Wwf, Wwf, Wwf^Es, Wwf^Es, Wwf, Wwf^Es, Wwf, Ai, Aa
Mm^Xm, Mm^Xm, Mm^Xm, Mm^Xm, Mm^Xm, Mm^Xm, Mm^Xm, Mm^Xm, Mm^Xm, Mm^Xm, Mm^Xm, Mm^Xm, Mm, Mm, Mm, Hhd^Fp, Mm, Hhd^Fp, Mm, Mm, Mm, Mm, Mm, Mm, Mm, Mm, Mm, Mm, Mm, Ha, Aa, Aa, Aa, Aa, Aa, Aa, Wwf, Aa, Aa, Aa, Aa, Wwf^Es, Wwf, Wwf, Aa, Aa
