Gd^Fp, Gd^Fp, Gd^Fp, Gll^Fmw, Gll^Fp, Gll^Fp, Gll^Fp, Ww, Ww, Ww, Wwf, Ww, Ai, Ai, Ai, Ww, Gd, Hhd, Hhd, Gd, Gd^Efm, Gd, Gd, Aa^Fpa, Aa^Fpa, Ww, Ai, Ww, Gd, Ww, Gd, Gd, Ai, Ai, Aa^Fpa, Aa^Fpa, Aa^Fpa, Aa^Fpa, Aa^Fpa, Aa^Fpa, Aa^Fpa, Ww
Gd^Fp, Gd^Fp, Gd^Fp, Gll^Fmw, Xu, Gll^Fmw, Gll^Fp, Wwf, Wwf, Wwf, Aa^Fpa, Gd, Ai, Ai, Ai, Ai, Wwf, Gd^Efm, Gd^Efm, Gd^Efm, Gd, Gd^Efm, Gd^Fp, Gll^Fp, Gll^Fp, Wwf, Wwf, Wwf, Gll^Fp, Wwf, Gd, Aa^Fpa, Ww, Ai, Aa^Fpa, Aa^Fpa, Aa^Fpa, Aa^Fpa, Aa^Fpa, Aa^Fpa, Aa^Fpa, Ww
Gd^Fp, Gd^Fp, Gd^Fp, Xu, Gd^Fp, Gd^Fp, Gd^Fp, Gll^Fp, Gll^Fp, Aa^Fpa, Gll^Fmw, Aa, Aa, Aa, Ai, Wwf, Wwf, Wwf, Wwf, Gd^Efm, Gd^Efm, Gd, Gll^Fmw, Gll^Fmw, Gll^Fmw, Gll^Fp, Gll^Fp, Gll^Fp, Gll^Fp, Wwf, Wwf, Ww, Ww, Aa^Fpa, Aa^Fpa, Aa^Fpa, Aa^Fpa, Aa^Fpa, Aa^Fpa, Aa^Fpa, Aa^Fpa, Aa^Fpa
Gd^Fp, Gd^Fp, Xu, Gd^Fp, Gll^Efm, Gd^Fp, Gll^Fmw, Gll^Fmw, Gll^Fmw, Gll^Fmw, Aa, Aa, Gll^Efm, Aa, Wwf, Wwf, Wwf, Wwf, Mm, Hhd, Gll^Fp, Gd, Gd^Efm, Gd^Efm, Gll^Fp, Gll^Fmw, Gd^Vhr, Gll^Fmw, Gll^Fp, Gll^Fp, Aa^Fpa, Wwf, Wwf, Ww, Aa^Fpa, Aa^Fpa, Aa^Fpa, Aa^Fpa, Aa^Fpa, Aa^Fpa, Aa^Fpa, Aa^Fpa
Hhd, Ha^Fp, Ha^Fp, Xu, Gll, Gd^Efm, Gd, Gll, Gd, Aa, Aa, Gd^Efm, Gd, Gll^Efm, Ai, Ai, Gll^Efm, Wwf, Wwf, Hhd, Aa^Fpa, Gd, Gd^Efm, Gd^Efm, Gll^Fmw, Gll^Fmw, Gll^Fmw, Gd, Ce, Ce, Ce, Aa^Fpa, Wwf, Ww, Aa^Fpa, Aa^Fpa, Ww, Ww, Gd, Aa, Aa^Fpa, Aa^Fpa
Hhd, Ms, Ha^Fp, Ha^Fp, Gd, Gll^Efm, Gd, Gll, Gll, Aa, Gd^Efm, Gll^Fmw, Wwf, Gd, Ai, Gd^Efm, Gd^Efm, Wwf, Hhd, Hhd, Gd^Efm, Gd, Gd^Efm, Gd^Efm, Gll^Fmw, Gll^Fmw, Gll^Fmw, Gd, Ce, 5 Ke, Ce, Aa^Fpa, Wwf, Wwf, Gd, Ww, Ai, Ai, Ai, Aa, Ai, Gd
Mm, Mm, Ms, Ha, Hhd, Xu, Xu, Gll, Gd^Efm, Gll, Gd^Efm, Gll^Fdw, Gll^Fmw, Wwf, Wwf, Ai, Ai, Ai, Hhd, Hhd, Gd, Gd, Gd, Gll^Fmw, Gll^Fmw, Gll^Fmw, Gll^Fp, Gd^Efm, Gll^Efm, Ce, Gll^Fp, Aa^Fpa, Gd, Wwf, Wwf, Wwf, Ww, Ai, Aa, Ai, Aa, Gd
Xu, Xu, Xu, Xu, Xu, Gd^Efm, Gd^Efm, Gd, Gd^Efm, Gd^Efm, Xu, Gll^Fp, Xu, Gll^Fmw, Hhd, Gd, Gd, Hhd, Hhd, Gd^Efm, Gd^Efm, Gll, Gll^Efm, Gll^Fmw, Gll^Fmw, Gll^Fmw, Gd, Gll^Efm, Gll, Gll^Fmw, Aa^Fmw, Gll^Fmw, Gll^Fmw, Gll^Fmw, Aa^Fp, Aa^Fp, Aa^Fp, Gd, Aa, Gd^Vhr, Gd^Efm, Aa
Xu, Xu, Uu^Vds, Isa, 6 Isa, Xu, Qlf, Gd^Efm, Gd, Gll, Qlf, Xu, Gll^Fdw, Gll^Fdw, Gll^Fp, Mm^Xm, Hhd, Hhd, Hhd, Gd^Efm, Gd^Efm, Gd^Efm, Gll^Efm, Gd^Efm, Gd, Gll^Fmw, Gd^Efm, Gll^Efm, Gll, Aa, Gd^Vhr, Aa^Fp, Aa^Fpa, Gll^Fmw, Aa^Fpa, Aa^Fp, Aa^Fpa, Aa^Fpa, Gll, Gll^Efm, Aa, Aa
Qlf, Xu, Xu, Isa, Xu, Xu, Qlf, Qlf, Gd^Efm, Gll^Fdw, Gll^Fdw, Qlf, Gll^Fdw, Gll^Fdw, Md, Mm^Xm, Md, Md, Md, Hhd, Hhd, Gd^Efm, Gll, Gll^Efm, Gd^Efm, Gd, Gd^Efm, Gd^Efm, Gll, Aa^Fp, Aa^Fp, Aa^Fp, Aa^Fp, Aa^Fpa, Aa^Fpa, Aa^Fpa, Aa^Fpa, Aa^Fmw, Gll, Aa, Aa, Aa
Qlf, Qlf, Xu, Rr^Pr|, Xu, Xu, Gll, Gd^Efm, Gll^Fdw, Gll^Fdw, Qlf, Gll^Fdw, Qlf, Gll^Fdw, Xu, Xu, Xu, Qlf, Ql, Hhd, Hhd, Isa, Isa, Gll^Efm, Gd^Efm, Gd^Efm, Gd, Gll, Gll^Fmw, Gll, Aa^Fmw, Aa^Fp, Aa^Fp, Aa^Fp, Aa^Fp, Aa^Fpa, Aa^Fpa, Aa^Fpa, Aa^Fpa, Aa^Fmw, Gd^Efm, Gd
Qlf, Qlf, Qlf, Qlf^Bcx|, Qlf, Hhd, Isa, Isa, Isa, Gll^Fdw, Xu, Ias, Qlf, Qlf, Qlf, Xu, Rr^Vd, Xu, Qlf, Ql, Ql, Ql, Isa, Gd^Efm, Gd^Efm, Gd^Efm, Gd, Gll^Fmw, Gll^Fp, Aa^Fmw, Gll^Fmw, Aa^Fpa, Aa^Fpa, Aa^Fpa, Aa^Fp, Aa, Aa, Aa^Fmw, Xu, Aa^Fmw, Aa^Fmw, Aa
Xu, Xu, Qlf, Isa, Qlf, Gll, Gd^Efm, Gd^Efm, Isa, Gll^Fdw, Xu, Xu, 4 Kh, Xu, Xu, Qlf, Qlf^Bcx/, Isa, Qlf, Ql, Ql, Ql, Ql, Isa, Isa, Gd^Efm, Gd, Gll, Gll^Fmw, Gll^Fmw, Gll^Fmw, Aa, Xu, Aa, Xu, Aa^Fp, Qlf, Xu, Xu, Xu, Aa^Fmw, Aa
Xu, Xu, Hhd, Isa, Isa, Gd^Efm, Xu, Isa, Gll^Fdw, Qlf, Qlf, Ch, Ch, Ch, Isa, Isa, Xu, Qlf, Rr^Vd, Isa, Isa, Ql, Isa, Isa, Isa, Gd^Efm, Gd^Efm, Gd^Efm, Gll^Fp, Gll^Fmw, Xu, Aa, Xu, Xu, Isa, Xu, Rr^Vd, Qlf, Qlf, Xu, Aa^Fmw, Aa^Fmw
Xu, Xu, Isa, Isa, Isa, Xu, Isa, Xu, Qlf, Qlf, Isa, Rr^Vd, Isa, Isa, Isa, Rr^Vd, Xu, Xu, Xu, Xu, Ql, Gll, Gll, Isa, Gd, Isa, Gd, Gd, Gd, Xu, Xu, Gd^Efm, Aa, Xu, Xu, Xu, Xu, Qlf, Xu, Isa, Xu, Aa^Fmw
Hhd, Isa, Isa, Isa, Isa, Hhd, Xu, Qlf, Qlf, Ch, Isa, Isa, Isa, Isa, Ch, Md, Qlf, Xu, Qlf, Xu, Hhd, Xu, Xu, Gll^Fdw, Gll^Fdw, Gd^Efm, Isa, Gd, Gd, Xu, Gd^Efm, Gd^Efm, Gd^Efm, Xu, Isa, Isa, Qlf, Qlf, Qlf, Qlf, Xu, Xu
Xu, Isa, Xu, Xu, Gll, Hhd, Qlf, Qlf, Gll^Efm, Isa, Qlf, Ch, Md, Ch, Md, Qlf, Qlf, Qlf, Xu, Hhd, Gll^Fmw, Xu, Gll^Fdw, Gll^Fmw, Xu, Xu, Isa, Gll^Fmw, Gd^Efm, Gd, Gd^Efm, Gd^Efm, Xu, Gd, Qlf, Isa, Xu, Xu, Qlf, Qlf, Xu, Xu
Gll, Gll^Efm, Isa, Isa, Gll, Xu, Xu, Gll^Efm, Gd^Efm, Qlf, Qlf, Qlf, Qlf, Md, Hhd, Xu, Xu, Qlf, Md, Md, Md, Gll^Fmw, Gll^Fmw, Gll^Fdw, Xu, Xu, Isa, Isa, Gd^Efm, Gd, Gd^Efm, Gd, Xu, Xu, Qlf, Qlf, Xu, Qlf, Rr^Vd, Xu, Xu, Xu
Qlf, Gd^Efm, Isa, Isa, Xu, Xu, Gll^Fdw, Gd, Isa, Gll^Fdw, Qlf, Xu, Qlf, Hhd, Xu, Xu, Xu, Hhd, Md, Md, Md, Gll^Fdw, Gll^Fmw, Gll^Fdw, Gll^Fmw, Xu, Isa, Isa, Gd^Efm, Gd^Efm, Xu, Gd, Xu, Xu, Qlf, Xu, Xu, Xu, Xu, Xu, Xu, Aa
Xu, Qlf, Gd, Gd^Efm, Qlf, Qlf, Gd, Isa, Isa, Isa, Qlf, Ql, Xu, Isa, Isa, Xu, Xu, Hhd, Gll^Fdw, Md, Gll^Fmw, Gll^Fp, Gll^Fdw, Gll^Fmw, Gd^Vhr, Isa, Aa^Es, Isa, Isa, Aa, Xu, Gll, Gd, Qlf, Xu, Xu, Xu, Isa, Xu, Xu, Gll^Fp, Gll
Xu, Qlf, Qlf, Gd^Efm, Isa, Qlf, Isa, Gd^Efm, Qlf, Qlf, Ql, Ql, Ql, Xu, Gll^Fdw, Xu, Xu, Xu, Gll^Fp, Gll^Fdw, Isa, Gll^Fmw, Gll^Fdw, Gll^Fmw, Isa, Isa, Aa, Aa^Es, Aa, Gd^Efm, Gd^Efm, Xu, Gd^Efm, Isa, Isa, Isa, Gll^Fp, Isa, Isa, Xu, Xu, Gll^Fp
Xu, Xu, Qlf, Gd, Qlf, Isa, Gll^Fdw, Qlf, Qlf, Qlf, Ql, Xu, Xu, Ql, Gll^Fdw, Xu, Hhd, Gll^Fp, Gd^Vhr, Isa, Isa, Gd, Isa, Gll^Fdw, Isa, Ww, Ww, Aa, Aa^Es, Aa^Es, Gd^Efm, Gll, Gd^Efm, Isa, Gd^Efm, Gd^Efm, Gll, Gll, Xu, Xu, Xu, Gll^Fp
Ql, Xu, Ql, Qlf, Xu, Qlf, Qlf, Qlf, Qlf, Qlf, Ql, Xu, Ql, Ql, Ql, Hhd, Hhd, Gll^Fp, Gll^Fmw, Gll^Fmw, Isa, Gll^Fmw, Isa, Isa, Ww, Ww, Ww, Ai, Aa, Ai, Wwf, Aa, Gd, Gd^Efm, Gll^Fp, Gd^Efm, Gll^Fp, Gll, Gll^Fp, Xu, Gll, Gll
Ql, Ql, Ql, Xu, Xu, Rr^Vd, Xu, Xu, Xu, Ql, Ql, Ql, Md, Md, Md, Hhd, Isa, Isa, Isa, Isa, Isa, Isa, Isa, Gd^Efm, Ww, Xu, Xu, Ww, Wwf, Wwf, Wwf, Aa, Aa, Ww, Hhd^Es, Hhd^Es, Gll^Fp, Gll^Fp, Gll, Gd^Efm, Gll, Gll^Fp
Ql, Ql, Ql, Ql, Xu, Xu, Xu, Xu, Xu, Ql, Ql, Ql, Md, Md, Xu, Gd, Gd^Vhr, Gd, Isa, Isa, Gd^Efm, Isa, Gd^Efm, Gd^Efm, Wwf, Xu, Xu, Gll^Fmw, Xu, Wwf, Wwf, Wwf, Aa, Wwf, Wwf, Xu, Gll^Fmw, Gll^Fp, Gll^Fp, Gll^Efm, Gll^Fp, Hhd^Es
Gll^Fdw, Xu, Ql, Ql, Ql, Ql, Xu, Isa, Isa, Ql, Ql, Ql, Gll^Fdw, Xu, Xu, Md, Gd, Gd^Efm, Gd, Isa, Ww, Wwf, Wwf, Wwf, Gll, Gll^Fmw, Xu, Xu, Gd^Efm, Gll^Fmw, Gll, Wwf, Wwf, Wwf, Gd, Xu, Hhd^Fmw, Hhd^Fp, Gll^Fmw, Gll^Fp, Gll^Fp, Hhd^Es
Gll^Fdw, Ql, Ql, Ql, Gll^Fdw, Ql, Xu, Ql, Ql, Ql^Bcx\, Re, Re, Gll^Fdw, Md, Gd, Md, Gd, Gd^Efm, Gll^Fmw, Gll^Fmw, Ww, Wwf, Wwf, Wwf, Wwf, Gll, Gd^Efm, Gd^Efm, Gd^Efm, Gll^Fmw, Gd, Aa, Ai, Ai, Gll^Fp, Hhd, Gll^Fp, Hhd^Fmw, Hhd, Gll^Fp, Gll^Fp, Gd
Re, Ql, Re, Re, Gll^Fdw, Ql, Gll^Fdw, Re, Re, Re, Re, Gll^Fdw, Gll^Fmw, Gll^Fmw, Gd, Gd^Efm, Gd^Efm, Gd^Efm, Gd, Ww, Ww, Aa, Aa, Wwf, Gll, Gll, Gll^Fmw, Gd^Efm, Gd^Efm, Gd^Efm, Gd, Gll, Ai, Ai, Gll^Fp, Gll^Fp, Gll, Hhd^Fp, Hhd^Fp, Hhd, Gd^Vhr, Gd
Ai, Re, Wwf, Re, Gll^Fdw, Gll^Fdw, Gll^Fp, Gll^Fp, Wwf, Gd^Vhr, Wwf, Re, Gll^Fmw, Gll^Fmw, Aa, Aa, Aa, Ai, Ai, Ai, Aa^Es, Aa, Aa^Es, Wwf, Wwf, Gll^Fmw, Gll^Fmw, Gd^Efm, Gd, Gll, Gd^Efm, Gll, Ai, Gll^Fp, Gll^Fp, Gll^Fp, Gll, Hhd^Fp, Hhd, Hhd, Hhd, Gd
Wwf, Wwf, Wwf, Wwf, Wwf, Gll^Fp, Gll, Gll^Fp, Ww, Wwf, Ww, Wwf, Wwf, Gd, Wwf, Aa, Wwf, Ai, Aa, Aa, Ai, Aa, Aa, Aa^Es, Aa^Es, Gll^Es, Gd^Efm, Gd, Gd, Gd^Efm, Gd, Gll, Gll^Fp, Gll^Fp, Gll^Fp, Gll^Fp, Gd, Hhd, Ce, Ce, Ce, Gd
Ai, Wwf, Wwf, Wwf, Wwf, Ww, Ww, Ww, Gll^Fp, Ww, Ww, Gll, Ww, Wwf, Ww, Wwf, Wwf, Gd, Gd, Aa^Es, Ai, Ai, Ai, Aa, Aa, Aa^Es, Gll^Es, Gd^Efm, Gd^Es, Gd^Efm, Gll, Gll, Hhd, Gll^Fp, Gll^Fp, Gll^Fp, Gd^Vhr, Gll^Fp, Ce, 3 Ke, Ce, Hhd
Mm, Mm^Xm, Mm, Ai, Ai, Ai, Hhd, Gll^Fmw, Gll^Fmw, Ww, Ww, Ww, Ww, Ww, Gd, Wwf, Wwf, Wwf, Wwf, Wwf, Wwf, Wwf, Ai, Aa, Aa, Aa^Es, Aa^Es, Gll^Es, Gd, Gd, Gd, Gll, Gll^Fp, Gll^Fp, Gll^Fp, Gll^Fp, Gll^Fp, Gll^Fp, Hhd^Fp, Ce, Gll^Fp, Hhd^Fp
Mm, Mm, Ai, Ai, Ai, Ai, Hhd, Aa^Fpa, Aa^Fpa, Aa^Fpa, Aa^Fpa, Gd, Gll, Gll, Ww, Ww, Ww, Ww, Ww, Wwf^Es, Gd, Gd, Ai, Ai, Aa^Es, Aa, Gll, Gll, Gd, Gd^Efm, Gd, Gd, Gll, Gll^Fp, Gll^Fp, Gll^Fp, Gll^Fp, Hhd^Fp, Hhd^Fp, Hhd^Fp, Hhd^Fp, Hhd^Fp
Mm^Xm, Mm, Mm^Xm, Mm, Mm, Mm, Mm, Mm, Mm^Xm, Aa^Fpa, Aa^Fpa, Aa^Fpa, Ww, Ww, Ww, Ww, Ai, Wwf, Wwf^Es, Wwf, Wwf^Es, Wwf, Gd, Ai, Aa^Es, Gll, Gll^Efm, Gd^Efm, Gd^Efm, Gd^Efm, Gll, Gll, Gll, Gd, Gll^Fp, Gll^Fp, Gll^Fmw, Gll^Fp, Gll^Fmw, Hhd^Fp, Hhd^Fp, Gll^Fp
Mm^Xm, Mm, Xu, Mm^Xm, Mm^Xm, Mm, Mm, Mm^Xm, Mm^Xm, Ai, Ai, Ai, Ai, Ww, Ai, Ww, Ai, Wwf^Es, Wwf, Wwf^Es, Gll, Wwf, Gd, Aa^Es, Gll, Aa, Gll, Gll^Efm, Gd^Efm, Gd^Efm, Gd^Efm, Gll, Gll, Gll^Fp, Gd^Vhr, Gd, Gll^Fmw, Hhd^Fmw, Hhd^Fp, Hhd^Fp, Hhd^Fp, Gll^Fp
Mm, Mm^Xm, Mm^Xm, Xu, Mm, Mm, Mm, Xu, Ias, Ai, Ai, Xu, Xu, Ai, Ai, Ai, Gd^Vhr, Gll, Gll^Fmw, Gll, Gll, Gll, Gll^Efm, Gll^Efm, Gll^Efm, Gll^Efm, Gll, Gd^Efm, Gd, Gd^Efm, Gd^Efm, Gd^Efm, Gll, Gll^Fp, Gll^Fmw, Gll^Fmw, Gll^Es, Hhd^Fp, Gll^Fp, Hhd^Fmw, Hhd^Fp, Gll^Fp
Xu, Mm^Xm, Mm^Xm, Mm^Xm, Xu, Mm, Isa, Xu, Xu, Xu, Xu, Aa^Fpa, Aa^Fpa, Aa^Fpa, Aa^Fpa, Gll^Fmw, Gll^Fmw, Gll^Fmw, Gll^Fmw, Gll^Fmw, Gll^Fmw, Gll, Aa, Gll, Aa, Aa, Aa, Gll^Efm, Gd^Efm, Gd^Efm, Gd^Efm, Gll, Gll^Fp, Gll^Fp, Gll^Es, Gll^Es, Hhd^Es, Hhd^Es, Gll^Fmw, Hhd^Fmw, Hhd^Fp, Hhd^Fp
Mm^Xm, Mm^Xm, Xu, Xu, Xu, Mm^Xm, Isa, Xu, Xu, Xu, Isa, Xu, Aa^Fpa, Aa^Fpa, Aa^Fpa, Hhd, Hhd, Hhd^Fmw, Gd^Fmw, Gll^Fp, Aa^Fpa, Aa^Fpa, Aa, Aa, Aa, Aa, Gll, Gll, Gd, Gd, Gd, Gll, Gd, Hhd, Hhd^Es, Hhd, Hhd^Fmw, Hhd^Fmw, Hhd^Fmw, Gll^Fp, Gll^Fp, Gll^Fp
Mm^Xm, Mm, Xu, Xu, Mm^Xm, Xu, Xu, Isa, Isa, Xu, Isa, Isa, Gd, Gll, Gd^Efm, Hhd, Hhd^Fmw, Hhd^Fmw, Gd^Fmw, Gll^Fp, Gll, Aa^Fpa, Gd, Gll, Gll, Gll, Gll^Efm, Gd^Efm, Gd, Ha, Ha, Ha, Gd^Efm, Hhd, Hhd, Gll^Fmw, Gll^Fmw, Gll^Fmw, Hhd^Fp, Hhd^Fmw, Gll^Fmw, Gll
Mm, Mm^Xm, Mm^Xm, Mm^Xm, Mm^Xm, Mm^Xm, Mm^Xm, Xu, Mm, Isa, Isa, Gll, Isa, Isa, Gd^Efm, Hhd, Gd^Efm, Hhd, Gd, Gll, Gll, Gll, Gd, Gll^Efm, Gll^Efm, Gll^Efm, Gll^Efm, Gll^Efm, Ha, Ha, Ha, Gd, Hhd^Fmw, Hhd^Fp, Hhd^Fmw, Hhd^Fmw, Hhd^Fp, Hhd^Fp, Hhd^Fp, Hhd^Fp, Xu, Gd
Xu, Mm^Xm, Mm^Xm, Uu^Vud, Cf, 2 Kf, Cf, Mm^Xm, Kf, Uu^Vud, Isa, Isa, Gll, Gd^Es, Gll^Efm, Gd^Efm, Gd^Efm, Gd^Efm, Gd^Efm, Gll, Gll^Fp, Gll, Gll, Gll, Gll, Gll^Efm, Gll, Ha, Ha, Ha, Aa, Gd, Gll^Fp, Hhd^Fmw, Hhd^Fmw, Hhd^Fmw, Hhd^Fp, Xu, Hhd^Fp, Hhd^Fp, Xu, Xu
Xu, Mm, Mm^Xm, Mm^Xm, Cf, Cf, Cf, Cf, Cf, Cf, Isa, Isa, Gd^Es, Gd^Es, Gd^Es, Gd^Efm, Gll, Gll, Hhd, Gll^Fp, Xu, Gll^Fmw, Gll^Fp, Gll^Fmw, Gll^Fp, Gll, Gll, Ha, Ha, Aa, Aa, Gd, Gll^Fp, Gll^Fp, Gll^Fmw, Hhd^Fp, Xu, Hhd^Es, Xu, Xu, Xu, Xu
Xu, Xu, Xu, Mm^Xm, Mm, Cf, Isa, Cf, Isa, Isa, Uu^Vud, Isa, 1 Gd^Es, Hhd, Gd^Es, Isa, Xu, Ias, Cf, Cf, Cf, Gll^Fmw, Gll^Fp, Gll^Fp, Gll^Fp, Gll, Gll, Gll, Aa, Aa, Aa, Aa, Gd, Gll^Fmw, Gll^Fp, Gll^Fmw, Xu, Xu, Xu, Xu, Xu, Xu
Xu, Xu, Mm^Xm, Mm^Xm, Mm, Isa, Isa, Isa, Uu^Vud, Isa, Hhd, Hhd, Hhd, Hhd, Isa, Isa, Cf, Xu, Xu, Cf, Xu, Xu, Gll^Fmw, Gll^Fp, Gll^Fp, Gll^Fp, Gll^Fp, Gll, Gll^Fp, Gd, Gll^Fp, Gll^Fp, Gd, Gll^Fp, Gll^Es, Gll^Es, Gll^Es, Xu, Xu, Xu, Xu, Xu
Xu, Mm^Xm, Mm^Xm, Mm^Xm, Mm^Xm, Hhd, Gll, Gll, Gll, Hhd, Xu, Hhd, Hhd, Isa, Xu, Xu, Xu, Xu, Xu, Xu, Xu, Xu, Gd, Gll^Fp, Aa^Fpa, Gll^Fp, Gll^Fp, Gll^Fp, Gll^Fp, Gll^Fp, Gll^Fp, Gll^Fp, Gll^Fp, Gll^Fp, Gll^Fp, Gll^Fp, Hhd^Fp, Xu, Xu, Xu, Xu, Xu
Gll^Fp, Mm^Xm, Mm^Xm, Mm^Xm, Mm^Xm, Mm, Ww, Ias, Gd, Hhd, Hhd, Hhd, Gd, Xu, Xu, Xu, Xu, Xu, Xu, Xu, Xu, Xu, Gd, Aa^Fpa, Aa^Fpa, Gll^Fp, Aa^Fpa, Gll^Fp, Gll^Fp, Gll^Fp, Gll^Fp, Gll^Fp, Gd, Gll^Fp, Gll^Fp, Hhd^Fp, Hhd^Fp, Hhd^Fp, Xu, Xu, Xu, Xu
