Gll^Fp, Aa^Fpa, Aa^Fpa, Aa^Fpa, Aa^Fpa, Aa^Fpa, Aa^Fpa, Aa^Fpa, Wwf, Aa^Fpa, Wwf, Wwf, Aa^Fpa, Wwf, Wwf, Aa^Fpa, Aa^Fpa, Aa^Fpa, Aa^Fpa, Gll^Fp, Gll^Fp, Gll^Fp, Gll^Fp, Gll^Fp, Gll^Fp, Gll^Fp, Gll^Fp, Gll^Fp, Gll^Fp, Gll^Fp, Gll^Fp, Gll^Fp, Gll^Fp, Gll^Fp, Gll^Fp, Gll^Fp, Gll^Fp, Gll^Fp, Gll^Fp, Gll^Fp, Gll^Fp, Gll^Fp, Gll^Fp, Gll^Fp
Gll^Fp, Aa^Fpa, Gll^Fp, Aa^Fpa, Aa^Fpa, Aa^Fpa, Aa^Fpa, Aa^Fpa, Wwf, Wwf, Wwf, Wwf, Aa^Fpa, Wwf, Aa^Fpa, Aa^Fpa, Aa^Fpa, Aa^Fpa, Gll^Fp, Gll^Fmw, Gll^Fmw, Gll^Fmw, Gll^Fmw, Gll^Fmw, Gll^Fp, Gll^Fp, Gll^Fmw, Gll^Fp, Gll^Fmw, Gll^Fmw, Gll^Fmw, Gll^Fmw, Gll^Fmw, Gll^Fp, Aa^Fpa, Aa^Fpa, Aa^Fpa, Gll^Fp, Aa, Gll^Fp, Aa, Gll^Fp, Gll^Fp, Gll^Fp
Gll^Fp, Aa^Fma, Gll^Fp, Gll^Fmw, Aa, Aa, Aa^Fpa, Aa, Aa, Wwf, Wwf, Aa^Fpa, Aa, Wwf, Wwf, Aa, Aa, Aa^Fpa, Aa^Fpa, Aa^Fpa, Aa^Fpa, Gll^Fp, Aa^Fpa, Gll^Fmw, Gd^Vhr, Aa^Fpa, Gll^Fmw, Aa^Fpa, Aa^Fpa, Gll^Fmw, Aa, Aa^Fpa, Aa^Fpa, Gll^Fp, Aa^Fpa, Aa^Fpa, Aa, Aa, Aa^Es, Aa, Gll^Fmw, Gll^Fmw, Gll^Fmw, Gll^Fp
Gll^Fp, Gll^Fp, Aa^Fma, Aa^Fma, Aa^Fma, Aa^Fpa, Aa^Fma, Aa^Fma, Aa^Fpa, Aa^Fpa, Wwf, Aa^Fpa, Aa^Fpa, Wwf, Aa^Fpa, Wwf, Wwf, Aa^Fpa, Aa^Fpa, Aa^Fpa, Aa^Fpa, Aa^Fpa, Gll^Fp, Aa^Fpa, Aa, Aa, Aa^Es, Gll^Fp, Aa, Aa, Aa, Aa^Fpa, Aa^Fpa, Aa^Fpa, Aa^Fpa, Aa, Aa, Aa^Es, Aa, Aa, Aa, Aa, Aa^Fpa, Gll^Fp
Gll^Fp, Gll^Fp, Gll^Fp, Aa^Fma, Gll^Fp, Aa^Fma, Aa^Fma, Aa^Fma, Aa^Fma, Aa^Fpa, Wwf, Wwf, Wwf, Wwf, Wwf, Aa^Fpa, Wwf, Aa, Aa^Fpa, Aa^Fpa, Aa^Fpa, Aa^Fpa, Aa^Fpa, Aa^Fpa, Aa^Fpa, Aa^Es, Aa^Es, Aa^Es, Aa, Aa, Aa, Aa^Fpa, Aa^Fpa, Aa^Fpa, Aa^Fpa, Aa^Fpa, Aa, Aa, Aa, Aa^Fpa, Aa^Fpa, Aa^Fpa, Aa^Fpa, Gll^Fp
Gll^Fp, Gll^Fp, Gll^Fmw, Gll^Es, Gd^Vhr, Aa, Aa^Fma, Aa^Fma, Aa^Fma, Aa^Fpa, Aa^Fma, Aa^Fma, Aa^Fma, Aa^Fpa, Aa^Fpa, Wwf, Aa, Aa^Es, Aa^Es, Aa^Fpa, Aa^Fpa, Aa^Fpa, Aa^Fpa, Aa^Fpa, Aa^Fpa, Aa^Fpa, Aa, Aa, Aa^Fpa, Aa^Fpa, Aa^Fpa, Aa^Fpa, Aa^Fpa, Aa^Fpa, Aa^Fpa, Aa^Fpa, Aa^Fpa, Aa^Es, Aa^Fpa, Aa^Fpa, Aa, Aa, Gll^Fmw, Gd
Gll^Fp, Gll^Fmw, Gll^Fp, Aa, Aa, Aa^Es, Aa, Aa^Fma, Aa^Fpa, Aa^Fma, Aa^Fma, Aa, Aa^Es, Aa^Fma, Wwf, Wwf, Aa^Fpa, Aa^Es, Aa, Aa, Aa^Fpa, Aa^Fpa, Aa^Fpa, Aa^Fpa, Aa^Fpa, Aa^Fpa, Aa^Fpa, Aa^Fpa, Aa^Fpa, Aa^Fpa, Aa^Fpa, Aa^Fpa, Aa^Fpa, Aa^Fpa, Aa^Fma, Aa^Fpa, Aa, Aa^Es, Aa^Es, Aa, Aa^Es, Aa, Gd, Gd
Gll^Fp, Gll^Fmw, Gd, Gll^Fp, Gd, Gd^Efm, Aa, Gll^Fp, Cvr, Cvr, Aa^Es, Aa, Aa^Es, Wwf, Wwf, Wwf, Wwf, Aa^Fpa, Aa, Aa^Fpa, Aa^Fma, Aa^Fpa, Aa^Fpa, Aa^Fpa, Aa^Fpa, Aa^Fpa, Aa^Fpa, Aa^Fpa, Aa^Fpa, Aa^Fpa, Aa, Aa^Fpa, Aa, Aa^Fpa, Aa, Aa, Aa^Fpa, Aa, Aa^Es, Aa^Es, Gd, Aa, Gd, Gll^Fp
Gd, Gll^Fmw, Gll^Fmw, Gll^Fmw, Gll^Fp, Gd, Gll^Fp, Aa, Gll^Fp, Gd^Es, Gd^Es, Aa^Es, Aa, Wwf, Aa^Fma, Wwf, Ai, Aa^Fpa, Aa, Aa^Fma, Aa^Fma, Aa^Fpa, Aa^Fma, Aa, Aa, Aa, Aa, Aa^Fpa, Aa^Fpa, Aa^Fma, Aa, Aa, Aa, Aa, Aa^Fpa, Aa^Fma, Aa^Fpa, Aa, Gll, Gll, Gll^Fp, Gd, Aa^Fpa, Aa^Fpa
Gll, Gll^Efm, Gll^Efm, Gll^Fmw, Gd, Gd, Gll, Gd, Gll^Fp, Gd^Efm, Gd^Efm, Aa^Fpa, Aa^Fpa, Aa, Aa^Fpa, Ai, Ai, Aa^Es, Aa, Aa^Fma, Aa^Fma, Aa^Fma, Aa^Fpa, Aa^Fma, Aa^Fma, Aa, Aa, Aa^Fma, Aa, Aa, Aa^Fma, Aa, Aa^Fpa, Aa^Fma, Aa^Fpa, Aa^Fpa, Aa, Aa, Gll^Efm, Gll^Fp, Aa^Fpa, Gll^Fp, Aa^Fpa, Aa^Fpa
Gll^Fp, Gll^Fp, Gll^Fp, Gll^Efm, Gll^Efm, Gll, Gll^Fp, Gll, Gd^Efm, Gd^Efm, Aa^Fpa, Gll^Fp, Aa, Aa^Fpa, Aa^Fpa, Aa^Fpa, Gd^Efm, Ai, Aa, Aa^Fpa, Aa^Fma, Aa^Fma, Gll^Fp, Aa, Aa, Aa, Gll^Fp, Aa^Fpa, Aa, Aa, Aa^Fma, Aa^Fma, Aa^Fma, Aa^Fma, Aa^Fpa, Aa^Fpa, Aa, Aa, Aa, Gd^Vhr, Gll, Aa^Fpa, Gd, Aa^Fpa
Gll^Fmw, Gll^Fmw, Gll^Fp, Gll^Fp, Gll^Fmw, Gll^Fmw, Gll^Fp, Gll, Gll^Efm, Gll^Fp, Gll^Fmw, Gll^Fp, Gll^Fmw, Aa, Aa^Fpa, Gll, Gll^Efm, Ai, Ai, Ai, Aa^Fma, Gll, Gll^Fp, Gll^Fp, Gd, Gll, Aa^Fpa, Aa^Fpa, Aa, Aa^Fma, Aa^Fma, Aa^Fma, Aa^Fma, Aa^Fma, Aa^Fma, Aa^Fpa, Cvr, Aa^Fpa, Aa^Fpa, Aa, Gll, Gll, Gd, Aa^Fpa
Gll^Fp, Gll^Fmw, Gd, Gd, Gd, Gll^Fp, Gll^Fp, Gd, Gll^Efm, Gll^Fp, Gll, Gll^Fmw, Gll^Fmw, Aa, Gll^Fp, Gll^Fp, Gll^Fp, Gd^Efm, Ai, Ai, Gll, Gll, Gll^Fp, Gd, Gd, Aa^Fpa, Gll, Gll^Efm, Gll^Efm, Gd, Aa^Fma, Aa^Fma, Aa^Fma, Aa^Fpa, Aa^Fma, Cvr, Aa^Fma, Aa^Fpa, Aa^Fpa, Gll^Fp, Aa^Fpa, Aa^Fma, Aa^Fma, Aa^Fpa
Gll^Fp, Gll^Fp, Gd, Aa, Aa, Gd, Gll^Fp, Gd, Gd, Gll^Efm, Aa^Efm, Gd, Gd, Gd^Efm, Gd^Efm, Gll^Fmw, 2 Gll^Fmw, Gll^Fmw, Gll^Fp, Ai, Gll^Fmw, Gll^Fp, Gll^Fmw, Gd, Gll^Fmw, Gll^Fmw, Gll^Fp, Gll^Efm, Gll, Gll, Ai, Ai, Ai, Aa^Fpa, Aa^Fpa, Aa^Fma, Aa^Fma, Aa^Fpa, Gll^Fp, Aa, Aa^Fpa, Aa^Fpa, Aa^Fma, Aa^Fpa
Gll^Fp, Gd, Aa, Aa, Gll^Fp, Gll^Fp, Gll^Fp, Aa^Fpa, Aa^Fpa, Aa, Aa^Fma, Aa^Fpa, Ai, Aa, Gd^Efm, Gd^Efm, Gll, Gll^Fp, Gll, Gll^Fp, Gd, Gll^Fmw, Gll, Gll^Fmw, Gll^Fp, Gll^Fp, Gll^Efm, Gll^Efm, Ai, Ai, Ai, Ai, Ai, Ai, Wwf, Aa^Fma, Aa^Fpa, Aa, Aa, Aa, Aa^Fma, Aa^Fma, Aa^Fpa, Aa^Fpa
Gll^Fp, Gd, Gd, Aa, Aa, Gll^Fp, Aa^Fpa, Aa, Aa, Aa^Fpa, Aa^Fma, Aa^Fma, Ai, Ai, Gll^Fp, Gd^Efm, Gll, Gll, Ai, Gll, Gll^Efm, Gll, Ai, Ai, Ai, Wwf, Wwf, Wwf, Ai, Aa^Fpa, Aa^Fma, Ai, Aa^Fma, Ai, Aa^Fma, Wwf, Wwf, Aa, Wwf, Aa^Fpa, Wwf, Wwf, Wwf, Wwf
Gll^Fp, Gll^Fp, Gd, Aa, Aa^Fpa, Aa, Aa^Fpa, Aa, Aa^Fpa, Aa^Fpa, Aa^Fma, Ai, Ai, Ai, Gll^Fp, Gll, Gll^Fmw, Ai, Gll^Fmw, Ai, Gll, Gd, Gll^Fmw, Ai, Gll^Fp, Aa^Fma, Aa^Fma, Gll^Fmw, Aa, Aa, Aa, Ai, Aa^Fma, Aa^Fma, Aa, Gll^Fmw, Gll^Fmw, Wwf, Aa, Wwf, Aa^Fpa, Wwf, Aa^Fpa, Gll^Fp
Gll^Fp, Gll^Fp, Gll^Fp, Aa, Aa, Aa, Aa, Aa^Fpa, Aa^Fma, Aa^Fma, Aa^Fpa, Ai, Aa^Fpa, Cvr, Aa^Fpa, Gll^Es, Gd^Es, Gll^Fp, Gll^Fmw, Gll^Fp, Gll^Fp, Gd, Gll^Fp, Gll^Fp, Gll^Efm, Aa^Fma, Gd^Efm, Aa^Fma, Gll^Fp, Aa, Gll^Fp, Aa, Gll^Fmw, Aa, Aa, Aa, Gll^Fmw, Gll^Fp, Gll^Fp, Gll^Fp, Gll^Fp, Gll^Fp, Gd, Gll^Fp
Gll^Fp, Gd, Gd, Gll^Fp, Gd^Es, Gd^Es, Gd^Es, Aa^Fma, Aa^Fma, Aa^Fma, Aa^Fpa, Aa^Fpa, Cvr, Cvr, Gd^Es, Gll^Es, Gll^Fp, Gll^Fp, Gll^Fmw, Gll^Fp, Ai, Gd, Gd^Efm, Gd^Efm, Gd^Efm, Gd^Efm, Gll, Gll, Gll, Gll, Gd, Gll^Fp, Gll^Fmw, Gll^Fp, Gll^Fp, Gll^Fmw, Aa^Fpa, Aa^Fpa, Aa^Fma, Gll^Fp, Aa^Fma, Gll^Fp, Gd, Gll^Fp
Gll^Fp, Gll^Fp, Gll^Fp, Gd, Gd, Gd^Es, Aa^Es, Aa, Aa, Aa^Fma, Aa^Fpa, Aa^Fpa, Aa^Fpa, Aa^Fpa, Gd, Gd^Es, Gd, Gll^Fp, Gll^Fp, Gll^Fmw, Ai, Gll^Fp, Gll^Fp, Gll^Fp, Gll, Gll^Vct, Ai, Aa^Fma, Gll^Fp, Gll, Aa^Fpa, Gll^Fmw, Gll^Fmw, Aa^Fpa, Aa^Fpa, Gll^Fp, Gll^Fp, Aa, Aa, Aa^Fma, Gll, Gll, Gll^Fp, Gll^Fp
Gll^Fp, Gll^Fmw, Gll^Fmw, Aa^Fpa, Gll^Fp, Gll^Es, Aa, Aa^Es, Aa^Fpa, Aa^Fpa, Aa^Fpa, Aa^Fpa, Aa^Fpa, Aa^Fpa, Aa^Fpa, Gll^Es, Ai, Gll^Fp, Ai, Ai, Ai, Gll^Fp, Gll, Gll, Ce, Ce, Ai, Aa^Fma, Aa^Fpa, Aa^Fpa, Aa^Fma, Aa^Fpa, Aa^Fma, Aa^Fpa, Gll^Fp, Aa, Gll^Fp, Aa, Gll^Fp, Gll, Aa^Fpa, Aa^Fma, Aa^Fma, Gll^Fp
Gll^Fp, Gll^Fmw, Aa^Fma, Aa^Fma, Aa^Fma, Aa, Aa^Fpa, Aa, Aa^Fma, Aa^Fma, Aa^Fpa, Aa^Fpa, Aa^Fpa, Aa^Fpa, Aa^Fpa, Aa^Fpa, Aa^Fpa, Ai, Aa^Fma, Ai, Ai, Gll^Fp, Gll, Gll^Vct, Ce, 1 Ke, Ce, Ai, Aa^Fpa, Aa^Fpa, Aa^Fma, Aa^Fma, Aa^Fma, Aa^Fma, Aa, Aa, Aa, Gll^Fp, Gll^Fp, Gll, Aa^Fma, Aa^Fma, Aa^Fpa, Gll^Fp
Gll^Fp, Gll^Fmw, Gll^Fmw, Aa^Fma, Aa^Fma, Aa^Fpa, Aa, Aa^Fma, Aa^Fma, Aa^Fpa, Aa^Fpa, Aa^Fpa, Aa^Fpa, Aa^Fpa, Aa, Cvr, Cvr, Gll^Fp, Aa, Aa, Gll^Fp, Gll^Fp, Gll, Re^Vct, Gll^Fmw, Ce, Gll^Fp, Aa^Fpa, Gll^Fp, Aa^Fma, Aa^Fpa, Gll^Fp, Gll^Fmw, Gll^Fp, Aa, Aa^Fpa, Aa^Fpa, Aa^Fpa, Aa^Fma, Gll, Gll, Gll, Gll, Gll^Fp
Gll^Fp, Gll^Fp, Gd^Vhr, Aa^Fma, Aa^Fpa, Aa^Fpa, Aa, Aa^Fpa, Aa^Fma, Aa^Fpa, Aa^Fpa, Aa^Fpa, Aa^Fpa, Aa, Gll^Fp, Gll^Fp, Aa^Fpa, Aa^Fma, Aa, Gll^Fp, Gll^Fp, Gll, Gd^Efm, Gll^Fmw, Gll^Es, Gll^Es, Gll^Vct, Gll^Fp, Gll^Fmw, Gll^Fmw, Gll^Fmw, Gll^Fmw, Aa^Fpa, Aa^Fpa, Aa, Aa^Fpa, Aa^Fma, Aa^Fpa, Gd^Vhr, Aa^Fma, Aa, Aa^Fpa, Gd, Gll^Fp
Gll^Fp, Gll^Fp, Aa, Aa, Aa, Aa, Aa, Aa^Fpa, Aa^Fpa, Aa^Fma, Aa^Fpa, Aa^Fpa, Aa^Fma, Aa, Aa, Aa^Fpa, Aa, Aa, Aa, Gll^Fp, Gd^Efm, Gd^Efm, Gd^Efm, Gll, Gd^Efm, Gll^Es, Gll^Fmw, Gll^Fmw, Aa, Gll^Fmw, Aa^Fma, Gll^Fp, Aa^Fpa, Aa, Aa^Fma, Aa^Fma, Aa^Fma, Aa^Fma, Aa^Fpa, Aa, Gll^Fp, Aa^Fpa, Gll^Fmw, Gll^Fp
Gll^Fp, Gll^Fp, Gll^Fmw, Gll^Fmw, Gd, Gd, Aa^Fma, Aa^Fpa, Aa^Fma, Aa^Fpa, Aa^Fpa, Aa, Aa, Aa^Fpa, Aa^Fma, Aa, Aa, Aa^Es, Gd^Es, Gd, Gll^Fp, Gd^Efm, Gll^Efm, Gd, Gll^Fmw, Gd^Efm, Gd^Efm, Gll^Fp, Gll^Fp, Aa, Aa^Fma, Aa^Fpa, Aa^Fpa, Aa^Fma, Aa^Fpa, Aa^Fma, Aa^Fma, Aa^Fma, Aa, Aa^Es, Aa, Aa^Fpa, Aa^Fpa, Gll^Fp
Gll^Fp, Gll^Fp, Gll^Fmw, Gll^Efm, Gd^Efm, Gll^Fmw, Aa^Fpa, Aa^Fma, Aa, Aa, Aa, Aa, Gll^Fp, Aa, Gll^Fp, Gd, Gd, Gll^Fp, Gd^Es, Gd, Gd, Gd^Efm, Gd, Gll^Fp, Gll^Fp, Gll^Fmw, Gll^Fmw, Gd^Efm, Gd, Aa, Aa^Fpa, Aa^Fma, Aa^Fma, Aa^Fma, Aa, Aa^Fpa, Aa, Aa^Fpa, Gll^Fmw, Aa, Aa^Fpa, Aa^Fpa, Aa^Fma, Aa^Fpa
Gll^Fp, Gll^Fmw, Gll^Fp, Gd^Efm, Gd, Aa, Aa, Gll^Fp, Aa^Es, Aa^Es, Gll^Fp, Gll^Fmw, Aa, Aa, Gll^Fp, Gd, Gll^Fp, Gd, Gll^Fmw, Gll^Fmw, Gll^Fmw, Gll^Fmw, Gd^Es, Gll^Fp, Gll^Fp, Gll^Fp, Gll^Fmw, Gll^Efm, Gd, Gd, Aa, Aa^Fma, Aa^Es, Aa, Aa^Es, Aa, Gll^Fmw, Aa^Fpa, Cvr, Cvr, Cvr, Aa^Fpa, Aa^Fma, Aa^Fpa
Gll^Fp, Gll^Fmw, Gll^Fmw, Gd, Gll^Fmw, Gll^Fmw, Gll^Fp, Aa, Gd^Es, Aa^Es, Gd, Gll^Fmw, Gll^Fmw, Gll^Fmw, Gll^Fmw, Gll^Fmw, Gll^Fmw, Gll^Fmw, Gll^Fp, Gll^Fp, Gd^Vhr, Gll^Fmw, Gll^Fmw, Gd, Gll^Fp, Aa, Aa, Aa, Gd^Efm, Gd^Efm, Aa, Aa, Aa, Aa^Fma, Aa^Es, Aa, Gll^Fp, Gll^Fmw, Gll^Fp, Cvr, Aa, Aa, Aa^Fpa, Aa^Fma
Gll^Fp, Gll^Fp, Gll^Fp, Gll^Fp, Gll^Fp, Gll^Fmw, Gll^Fp, Gd, Gll^Fp, Gd^Es, Gll^Fp, Gll^Fp, Gll^Fp, Gll^Fmw, Gll^Fp, Gll^Fp, Gll^Fp, Gll^Fmw, Gll^Fmw, Gll^Fp, Gll^Fmw, Gll^Fmw, Gll^Fmw, Gd, Gll^Fp, Gll^Fp, Gll^Fp, Gll^Fp, Gll^Fp, Gd, Gd, Gd, Gd^Es, Gd^Es, Aa, Aa, Gll^Fp, Aa^Fpa, Gll^Fp, Gll^Fp, Aa^Fma, Gll^Fp, Aa^Fpa, Aa^Fpa
Gll^Fp, Gll^Fp, Gll^Fp, Gll^Fp, Gll^Fp, Gll^Fp, Gll^Fp, Gll^Fp, Gll^Fp, Gll^Fp, Gll^Fp, Gll^Fp, Gll^Fp, Gll^Fp, Gll^Fp, Gll^Fp, Gll^Fp, Gll^Fmw, Gll^Fp, Gll^Fmw, Gll^Fp, Gll^Fmw, Gll^Fp, Gd, Gd, Gd, Gd, Gd, Gll^Fp, Gll^Fp, Gll^Fp, Gd, Gd, Gll^Fp, Gll^Fp, Gll^Fp, Gll^Fp, Aa^Fpa, Gll^Fp, Gll^Fp, Gll^Fp, Aa^Fpa, Gll^Fp, Gll^Fp
