Xu, Xu, Xu, Xu, Xu, Xu, Xu, Xu, Xu, Xu, Xu, Xu, Xu, Xu, Xu, Xu, Xu, Xu, Xu, Xu, Xu, Xu, Xu, Xu, Xu, Xu, Xu, Xu, Xu, Xu, Xu, Xu, Xu, Xu, Xu, Xu, Xu, Xu, Xu, Xu, Xu, Xu, Xu, Xu, Xu, Xu, Xu, Xu, Xu, Xu
Xu, Xu, Xu, Xu, Xu, Xu, Tb^Tf, Xu, Xu, Xu, Xu, Xu, Xu, Xu, Xu, Xu, Xu, Xu, Xu, Xu, Xu, Xu, Qxua, Qxua, Qxua, Xu, Xu, Xu, Xu, Xu, Xu, Xu, Xu, Xu, Xu, Xu, Xu, Xu, Xu, Xu, Xu, Xu, Isa, Isa, Xu, Xu, Xu, Xu, Xu, Xu
Xu, Xu, Tb^Tf, Tb^Tf, Tb^Tf, Tb^Tf, Uu, Uu, Isa^Edb, Xu, Xu, Isa, Tb^Tf, Xu, Xu, Xu, Xu, Xu, Xu, Xu, Qxua, Qxua, Qxua, Qxua, Qxua, Qxua, Qxua, Qxua, Qxua, Xu, Xu, Xu, Xu, Xu, Isa, Xu, Xu, Ql, Ql, Ql, Ql, Xu, Xu, Isa, Isa^Edb, Tb^Tf, Tb^Tf, Tb^Tf, Xu, Xu
Xu, Xu, Tb^Tf, Tb^Tf, Uu, Tb^Tf, Uu, Isa^Edb, Isa^Edb, Isa^Edb, Xu, Isa, Xu, Xu, Uu^Vu, Xu, Xu, Xu, Qxua, Xu, Qxua, Qxua, Qxua, Qxua, Isa^Edb, Qxua, Isa^Edb, Qxua, Qxua, Xu, Xu, Xu, Xu, Xu, Xu, Xu, Xu, Ql, Xu, Xu, Xu, Ql, Xu, Isa^Edb, Isa^Edb, Uu, Tb^Tf, Tb^Tf, Xu, Xu
Xu, Xu, Xu, Xu, Isa^Edb, Isa^Edb, Xu, Isa^Edb, Isa^Edb, Xu, Xu, Xu, Xu, Xu, Xu, Xu, Xu, Xu, Qxua, Qxua, Qxua, Qxua, Isa^Edb, Isa^Edb, Isa^Edb, Isa^Edb, Isa^Edb, Isa^Edb, Qxua, Isa^Edb, Qxua, Xu, Xu, Xu, Ql, Xu, Ql, Ql, Xu, Xu, Ql, Ql, Xu, Xu, Xu, Xu, Xu, Xu, Xu, Xu
Xu, Xu, Xu, Xu, Xu, Isa^Edb, Xu, Isa^Edb, Isa^Edb, Isa^Edb, Xu, Xu, Xu, Xu, Xu, Xu, Xu, Xu, Xu, Qxua, Xu, Qxua, Isa^Edb, Isa^Ebn, Isa^Qov, Isa^Qov, Isa^Qov, Isa^Ebn, Isa^Edb, Qxua, Qxua, Qxua, Xu, Ql, Xu, Ql, Xu, Xu, Xu, Xu, Ql, Xu, Xu, Xu, Xu, Xu, Xu, Xu, Xu, Xu
Xu, Xu, Xu, Xu, Xu, Xu, Xu, Xu, Xu, Xu, Qlf, Xu, Qlf, Xu, Xu, Xu, Xu, Ql, Ql, Xu, Qxua, Isa^Edb, Isa^Ebn, Isa^Edb, Isa^Qov, Isa^Qov, Isa^Qov, Isa^Edb, Isa^Ebn, Isa^Edb, Xu, Qxua, Xu, Xu, Xu, Xu, Xu, Xu, Xu, Xu, Xu, Xu, Ql, Xu, Xu, Xu, Xu, Xu, Xu, Xu
Ql, Xu, Ql, Xu, Xu, Xu, Ql, Xu, Isa^Edb, Xu, Qlf, Qlf, Qlf, Qlf, Xu, Xu, Ql, Ql, Ql, Xu, Xu, Qxua, Qxua, Isa^Edb, Uu, Isa^Qov, Isa^Edb, Isa^Edb, Isa^Edb, Xu, Qxua, Qxua, Qxua, Xu, Qxua, Xu, Qlf, Xu, Qlf, Ql, Ql, Ql, Ql, Ql, Xu, Ql, Ql, Ql, Xu, Ql
Xu, Ql, Ql, Ql, Ql, Xu, Xu, Xu, Isa^Edb, Ql, Qlf, Qlf, Xu, Ql, Xu, Ql, Xu, Ql, Ql, Ql, Xu, Qxua, Xu, Isa^Edb, Uu, Isa^Edb, Isa^Edb, Qxua, Qxua, Qxua, Qxua, Qxua, Xu, Qxua, Xu, Xu, Qlf, Qlf, Qlf, Ql, Xu, Ql, Xu, Ql, Xu, Ql, Xu, Ql, Xu, Ql
Xu, Ql, Ql, Ql, Xu, Xu, Qxua, Qxua, Isa^Edb, Isa^Edb, Ql, Ql, Xu, Xu, Ql, Ql, Ql, Xu, Xu, Ql, Ql, Xu, Xu, Isa^Edb, Xu, Uu, Qxua, Xu, Xu, Qxua, Xu, Xu, Xu, Xu, Xu, Qlf, Qlf, Qlf, Ql, Ql, Xu, Xu, Ql, Ql, Xu, Xu, Xu, Xu, Xu, Xu
Xu, Xu, Xu, Xu, Xu, Xu, Xu, Qxua, Xoa, Xu, Ql, Xu, Xu, Ql, Xu, Xu, Xu, Ql, Xu, Xu, Ql, Xu, Xu, Qxua, Xoa, Uu, Xu, Xu, Xu, Qxua, Xu, Xu, Xu, Xu, Xu, Xu, Xu, Xu, Ql, Ql, Xoa, Xu, Ql, Ql, Xu, Xu, Ql, Xu, Xu, Xu
Ql, Xu, Xu, Xoa, Ql, Ql, Xu, Xu, Xu, Xoa, Xu, Ql, Xu, Xu, Xu, Xu, Xu, Xu, Xu, Ql, Ql, Ql, Xoa, Xoa, Uu, Uu, Xu, Xu, Xu, Xu, Xu, Xu, Xu, Xu, Xu, Xu, Xu, Xu, Ql, Xoa, Xoa, Xoa, Xu, Xu, Ql, Ql, Xu, Ql, Ql, Xu
Xu, Ql, Ql, Ql, Ql, Xu, Xu, Ql, Isa^Edb, Xoa, Xoa, Xu, Isa^Edb, Xu, Ql, Ql, Xu, Xu, Xu, Ql, Ql, Xu, Xu, Xoa, Xoa, Xoa, Xu, Xu, Xu, Xu, Tb^Tf, Uu, Xu, Xu, Xu, Ql, Xu, Xu, Ql, Ql, Xu, Xoa, Xoa, Xu, Xu, Xoa, Xoa, Xu, Xoa, Xu
Xoa, Xoa, Xoa, Xoa, Xoa, Xoa, Xu, Xu, Ql, Xu, Xoa, Xu, Xu, Ql, Xu, Isa^Edb, Qxua, Xu, Xu, Xu, Xoa, Ql, Ql, Xu, Xoa, Xoa, Xoa, Xoa, Xoa, Xu, Tb, Tb^Tf, Xu, Ql, Qlf, Ql, Xu, Xu, Xu, Xu, Ql, Xoa, Xu, Xu, Ql, Xu, Xu, Xoa, Xu, Xu
Xu, Xoa, Uh, Xoa, Xu, Xoa, Xu, Ql, Ql, Xu, Xu, Xoa, Xu, Xu, Xu, Xu, Xu, Xu, Xu, Xoa, Uu, Xu, Xu, Xu, Xu, Xu, Xoa, Xoa, Xoa, Tb^Tf, Tb^Tf, Xu, Xu, Qlf, Qlf, Ql, Xu, Xu, Xu, Xu, Xu, Ql, Ql, Ql, Ql, Ql, Ql, Xu, Xu, Xu
Ql, Xu, Tb^Tf, Xu, Ql, Rr^Vd, Ql, Ql, Ql, Xu, Xu, Xu, Xu, Xu, Isa^Ii, Isa, Uu, Uh, Tb^Tf, Xu, Uu, Uu, Xu, Xu, Ql, Xu, Xoa, Xoa, Xoa, Uu, Xu, Tb, Xoa, Xu, Xu, Xu, Xu, Xu, Tb, Xu, Tb^Tf, Xu, Xu, Xu, Xu, Xu, Xu, Xoa, Xu, Xu
Ql, Ql, Ql, Ql, Ql, Ql, Xu, Ql, Xu, Xu, Isa, Isa^Ii, Xu, Xu, Uu, Tb^Tf, Xu, Tb^Tf, Xu, Xu, Uu, Xu, Xu, Xu, Xu, Ql, Uu, Xu, Xu, Xu, Xu, Xu, Xu, Xu, Xu, Xu, Uu^Edb, Xu, Tb^Tf, Uu, Xoa, Xu, Xu, Xu, Xu, Xu, Xoa, Xoa, Tb^Tf, Xu
Ql, Ql, Ql, Ch, Ql, Ql, Xu, Xu, Xu, Xu, Xu, Isa, Uu^Vu, Xu, Xoa, Xu, Xoa, Uh, Xu, Uu, Ql, Ql, Ql, Ql, Xu, Ql, Ql, Uu, Ql, Xu, Ql, Xu, Xu, Xu, Xu, Tb^Tf, Tb^Tf, Tb^Tf, Xoa, Tb, Tb^Tf, Xu, Uu^Edb, Xu, Xu, Xu, Xoa, Xu, Xu, Xu
Ql, Ch, Ql, Ql, Ql, Ql, Ch, Xu, Ql, Isa, Isa, Uh, Tb^Tf, Xu, Uu, Uu^Edb, Uu^Edb, Uu^Edb, Uu^Edb, Ql, Xu, Ql, Xu, Xu, Xu, Xu, Ql, Ql, Uu, Ql, Ql, Ql, Ql, Ql, Ql, Xu, Xu, Tb, Xoa, Xoa, Xu, Uu^Edb, Xoa, Xoa, Xoa, Xoa, Xu, Xoa, Tb^Tf, Xu
Ql, Ql, Ch, 5 Kh, Ql, Ch, Ql, Ql, Ql, Ql, Xoa, Xu, Xoa, Xoa, Xoa, Xoa, Uu, Uu^Edb, Ql, Ql, Xu, Xu, Xu, Xu, Xu, Xu, Xu, Xu, Xu, Uu^Edb, Uu^Edb, 6 Uu^Edb, Uu^Edb, Uu^Edb, Uu^Edb, Ql, Ql, Xu, Xu, Xu, Xu, Xu, Xoa, Xoa, Xu, Xu, Xu, Tb^Tf, Xoa, Xu
Ql, Ql, Uh, Ch, Uh, Ch, Ql, Ql, Ql, Ql, Xu, Xoa, Xoa, Xoa, Xu, Xu, Ql, Uu, Ql, Xu, Uu, Xu, Xu, Isa, Xu, Xu, Xu, Xu, Xu, Xu, Xu, Xu, Xu, Uu^Edb, Xu, Xu, Ql, Xu, Xu, Xu, Xu, Xoa, Xoa, Xu, Ql, Xu, Xu, Xu, Xoa, Xu
Ql, Ql, Ql, Uh, Isa, Ql, Ql, Ql, Ql, Rr^Vd, Xu, Xoa, Xu, Xu, Xu, Ql, Xu, Ql, Xu, Xu, Uu, Xu, Xu, Isa, Isa, Xu, Isa, Xu, Xu, Xu, Xu, Xu, Xoa, Uu, Xoa, Xu, Xoa, Xu, Xu, Xu, Isa, Xoa, Xoa, Xu, Xu, Ql, Xu, Xu, Xoa, Xu
Ql, Ql, Uh, Ql, Ql, Isa, Ch, Ql, Ql, Ql, Ql, Xu, Xu, Tb^Tf, Xu, Xu, Xu, Xu, Ql, Xu, Uu, Xu, Xu, Isa, Isa^Ii, Isa, Isa, Isa, Xu, Xu, Xu, Tb^Tf, Xoa, Xoa, Xu, Xoa, Xoa, Xu, Xu, Isa, Isa, Xu, Xu, Xoa, Xu, Ql, Tb^Tf, Tb^Tf, Xu, Xu
Ql, Ql, Ql, Ql, Xu, Xu, Xu, Ql, Ql, Ql, Ql, Xu, Ql, Ql, Ql, Ql, Ql, Ql, Xu, Ql, Xu, Xu, Isa, Isa, Isa^Ii, Isa^Ii, Isa, Xu, Xu, Xu, Tb^Tf, Tb^Tf, Xu, Xu, Ql, Xu, Xu, Xoa, Xu, Isa, Isa^Ii, Isa^Ii, Xu, Xoa, Xu, Xu, Xu, Xoa, Xu, Xu
Ql, Ql, Ql, Ql, Xu, Xu, Ql, Ql, Ql, Ql, Ql, Ql, Ql, Tb^Tf, Tb^Edb, Ql, Ql, Ql, Ql, Ql, Ql, Xu, Xu, Xu, Ql, Isa, Ql, Ql, Ql, Ql, Xoa, Tb^Tf, Xu, Xu, Ql, Xu, Ql, Xu, Xu, Xu, Isa, Isa^Ii, Isa^Ii, Xu, Xu, Ql, Ql, Ql, Xu, Xu
Uu, Ql, Ql, Ql, Xoa, Ql, Xuc^Efs, Ql, Isa, Ql, Xu, Rr^Vd, Xu, Tb^Tf, Uu^Edb, Uu^Edb, Uh, Ql, Xu, Ql, Ql, Ql, Ql, Ql, Uu^Edb, Ql, Ql, Ql, Ql, Ql, Ql, Xoa, Ql, Ql, Ql, Ql, Ql, Ql, Xu, Xu, Xu, Isa^Ii, Isa, Isa, Isa, Xu, Xu, Ql, Xu, Xu
Xu, Uh, Uu^Vu, Xu, Xu, Xuc^Efs, Isa, Isa^Ii, Isa, Xu, Isa, Xu, Rb^Edb, Rb^Edb, Rb^Edb, Uh, Xu, Xu, Xu, Ql, Ql, Ql, Xu, Ql, Ql, Ql, Xu, Xu, Xoa, Ql, Xoa, Ql, Ql, Ql, Ql, Ql^Ii, Ql, Uu, Xu, Xu, Isa, Isa, Xu, Isa, Xu, Xu, Uu, Xu, Xu, Xu
Xu, Uh, Uh, Uu, Xu, Xuc^Efs, Xu, Isa^Ii, Xu, Isa, Xu, Isa, Uu^Edb, Uu^Edb, Uh, Isa, Xu, Xu, Xu, Xu, Uu, Xu, Xu, Tb^Tf, Tb^Tf, Xu, Xu, Xu, Uu, Xoa, Xoa, Xoa, Ql, Xoa, Xu, Ql, Ql, Xu, Isa, Xu, Xu, Xu, Xu, Xu, Uu, Xu, Xu, Ql, Xu, Xu
Xu, Uu, Xu, Xu, Uu^Edb, Xoa, Xu, Xu, Xu, Xu, Xu, Uh, Xuc^Efs, Uh, Xu, Xu, Xu, Xu, Isa, Rb^Es, Rb^Es, Xu, Xu, Xu, Xu, Xu, Isa, Xu, Xu, Xu, Rb^Es, Xoa, Uu, Ql, Ql, Ql, Ql, Ql, Ql, Uu, Tb^Tf, Xu, Uu, Uu^Vu, Uu, Xu, Xu, Ql, Uu, Xu
Uu, Uu, Uu, Uu, Xu, Uu^Edb, Uu^Edb, Rb^Edb, Uu^Edb, Uu^Edb, Xu, Xuc^Efs, Xuc^Efs, Xu, Uu^Edb, Isa^Edb, Uu, Xu, Xuc^Efs, Rb^Es, Uh, Uh, Wwf, Xu, Xu, Xu, Isa^Ii, Isa^Ii, Isa, Rb^Edb, Rb^Edb, Xu, Uu, Uu, Xu, Xu, Xu, Ql, Ql, Ql, Ql, Tb^Tf, Ql, Ql, Uu, Ql, Ql, Rr^Vd, Ql, Xu
Xu, Uu, Xu, Xu, Ql, Ql, Uu, Uu^Edb, Xoa, Uu^Edb, Xuc^Efs, Xuc^Efs, Tb^Tf, Xu, Uu^Edb, Isa^Edb, Xuc^Efs, Xuc^Efs, Uh, Xu, Tb^Tf, Xu, Wwf, Xu, Isa, Isa, Xu, Isa^Ii, Isa, Uu^Edb, Uu^Edb, Uu^Edb, Uu, Uu, Ql^Ii, Rr^Vd, Ql^Ii, Ql, Ql, Ql, Ql, Ql, Ql, Uu, Uu, Ql, Ql, Ql, Ql, Ql
Xoa, Xoa, Xu, Xu, Ql, Ql, Xu, Xoa, Rb^Es, Uu, Xu, Isa, Isa^Edb, Uu^Edb, Uh, Uh, Uh, Uu, Ql, Tb^Tf, Ql, Ql, Ql, Xu, Xu, Xu, Xu, Xu, Xu, Xu, Tb^Tf, Xu, Isa, Ql, Ql^Ii, Ql^Ii, Ql^Ii, Ql^Ii, Ql, Ql, Ql, Ql, Xu, Xu, Ql, Ql, Ql, Ql, Ql, Ql
Ql, Ql, Ql, Ql, Ql, Xu, Xoa, Xoa, Xoa, Xu, Xu, Isa^Edb, Ql, Uu^Edb, Uh, Uh, Ql, Xu, Ql, Ql, Xu, Ql, Xu, Xu, Ql, Xu, Ql, Xu, Xu, Tb^Tf, Xu, Uu, Isa, Ql, Ql, Ql^Ii, Ql^Ii, Ql^Ii, Ql, Xu, Xu, Xu, Xu, Ql, Ql, Ql, Ql, Ql, Ql, Ql
Xoa, Ql, Ql, Ql, Ql, Xu, Ql, Ql, Ql, Ql, Xu, Xu, Ql, Uh, Ql, Xu, Ql, Ql, Ql, Ql, Ql, Xu, Ql, Ql, Ql, Ql, Xu, Ql, Ql, Xu, Uu, Isa, Isa, Xu, Ql, Ql^Ii, Ql, Ql, Ql, Xu, Xu, Xu, Xu, Ql, Ql, Ql, Ql, Ql, Ql, Ql
Xu, Xoa, Xu, Ql, Ql, Xu, Xu, Ql, Ql, Ql, Ql, Xoa, Ql, Ql, Ql, Xu, Ql, Ql, Ql, Isa^Edb, Xuc^Efs, Xu, Xu, Ql, Xu, Xu, Xu, Xu, Xu, Uu, Xu, Xu, Xu, Xu, Ql, Ql, Ql^Ii, Ql^Ii, Xu, Xu, Xu, Xu, 4 Kh, Xu, Ql, Ql, Ql, Ql, Ql, Ql
Xu, Xu, Uu, Xu, Isa^Edb, Ql, Xu, Ql, Isa, Ql, Xoa, Xu, Uh, Ql, Xu, Uh, Xu, Xu, Xu, Isa^Edb, Xu, Xu, Xu, Xu, Xu, Xu, Uh, Xu, Xu, Ql, Ql, Rr^Vd, Ql, Ql, Ql, Ql, Uu^Ii, Ql, Ql, Xu, Xu, Ch, Ch, Ch, Ch, Ch, Ql, Ql, Ql, Ql
Uu, Uu, Uu, Xu, Isa^Edb, Isa^Ii, Isa^Ii, Isa^Edb, Isa, Xu, Xoa, Xu, Xu, Ql, Ql, Xu, Xu, Xu, Xu, Isa, Xu, Xu, Xu, Xu, Tb^Emf, Uu, Isa, Uu, Xu, Uu, Isa, Ql, Ql, Ql, Ql, Uu, Ql^Ii, Uu, Ql, Xu, Uu, Ql, Ql^Bcx|, Ql, Ql, Ql^Bcx\, Ch, Ql, Ql, Ql
Uu, Xu, Isa^Edb, Isa^Edb, Uh, Isa^Ii, Isa^Ii, Isa, Xu, Xoa, Xu, Xu, Uh^Emf, Ql, Ql, Uh, Uh^Edb, Xu, Uu^Edb, Xu, Xu, Tb^Tf, Tb^Tf, Tb^Tf, Xu, Uu^Emf, Tb^Tf, Xu, Isa^Emf, Isa, Uu, Xu, Uu, Ql, Ql, Ql, Ql^Ii, Uu^Ii, Uu^Ii, Uu, Ql^Ii, Ql^Bcx\, Ch, Ql, Ql, Ql, Ql, Ql, Ql, Xu
Uu, Xu, Xu, Uu^Vu, Uh, Xoa, Uh^Emf, Isa, Ql, Xoa, Ql, Xu, Ql, Ql, Xu, Xu, Xu, Uh^Edb, Xu, Uu^Edb, Uu^Edb, Xu, Xu, Xu, Xu, Xu, Tb^Tf, Uu, Xu, Uu, Tb^Tf, Xu, Ql, Ql, Ql, Ql, Ql^Ii, Ql^Ii, Ql^Ii, Ql^Ii, Ql^Ii, Ql^Ii, Ql^Ii, Ql^Ii, Ql, Ql, Ql, Ql, Xu, Xu
Xu, Uu, Xu, Xu, Xu, Uh, Xu, Ql, Ql, Ql, Ql, Ql, Xuc^Efs, Xuc^Efs, Xuc^Efs, Xu, Xuc^Efs, Xu, Xu, Uu^Edb, Xu, Uu, Xu, Xu, Xu, Xu, Xu, Xu, Xoa, Xu, Xu, Ql, Ql, Ql, Rr^Vd, Ql^Ii, Ql^Ii, Ql^Ii, Ql, Ql^Ii, Ql, Ql, Ql, Ql^Ii, Ql, Ql, Ql, Ql, Xu, Xu
Xoa, Xoa, Xu, Uu, Uu^Emf, Xu, Ql, Xu, Ql, Xoa, Xoa, Xu, Xuc^Efs, Isa, Isa^Edb, Xuc^Efs, Isa, Xu, Isa, Xu, Isa, Isa, Xu, Xu, Isa, Xu, Xu, Rb^Es, Rb^Es, Xu, Xu, Ql, Xu, Xu, Xu, Ql, Ql^Ii, Ql, Ql, Ql, Rr^Vd, Ql, Xu, Ql, Ql, Xoa, Isa, Xoa, Uu, Xu
Xoa, Xu, Xu, Uu, Tb^Tf, Ql, Ql, Ql, Xu, Xoa, Xuc^Efs, Xuc^Efs, Xuc^Efs, Uh, Isa^Edb, Isa, Xu, Isa, Isa^Ii, Isa^Ii, Isa, Isa, Isa^Edb, Isa^Edb, Isa, Xu, Xoa, Xoa, Xoa, Xu, Isa, Tb^Tf, Tb^Tf, Xu, Tb^Tf, Ql^Ii, Ql^Ii, Ql, Ql, Xu, Xu, Xu, Xu, Ql, Ql, Isa, Xoa, Xu, Xoa, Xoa
Ql, Xu, Ql, Xoa, Ql, Ql, Xoa, Xoa, Qxua, Xu, Xuc^Efs, Xuc^Efs, Uh^Emf, Uh, Isa^Edb, Isa^Edb, Isa, Isa^Ii, Isa^Ii, Isa^Ii, Isa^Ii, Isa^Edb, Isa^Edb, Isa^Edb, Xu, Xu, Xoa, Uu, Xu, Xu, Xu, Uu, Xu, Tb^Tf, Uh^Emf, Ql^Ii, Ql^Ii, Ql^Ii, Ql, Xu, Ql, Xu, Ql, Ql, Ql, Ql, Xu, Xu, Xoa, Xu
Xoa, Ql, Ql, Ql, Xu, Xu, Xu, Qxua, Qxua, Xu, Xuc^Efs, Uh, Uh^Emf, Uh, Isa^Edb, Isa^Edb, Isa^Edb, Isa, Isa, Isa^Ii, Isa, Isa^Ii, Isa, Isa, Isa, Xu, Uu, Uu, Xu, Xu, Isa^Edb, Uu, Isa^Emf, Isa, Isa, Xu, Xu, Ql, Ql, Ql, Uu, Ql, Ql, Ql, Ql, Ql, Isa, Xu, Xu, Xu
Xoa, Ql, Ql, Xu, Xu, Uu, Xu, Xu, Xoa, Xu, Xoa, Xu, Xu, Isa, Isa, Isa, Isa, Isa, Xu, Isa, Isa, Isa, Xu, Xu, Xu, Xu, Xu, Xu, Xu, Xu, Tb^Tf, Uu^Edb, Qlf, Isa, Xu, Xu, Xoa, Xoa, Tb^Tf, Ql, Uu, Uu, Ql, Ql, Ql, Ql, Ql, Xu, Tb^Tf, Xu
Xu, Xu, Xu, Ql, Xu, Uu, Tb^Tf, Xu, Xu, Xoa, Xoa, Xoa, Xu, Xu, Isa, Xu, Xu, Xu, Xu, Xu, Xu, Xu, Uh, Xuc^Efs, Uh, Xu, Uh, Xu, Uh, Xu, Xu, Qlf, Qlf, Qlf, Qlf, Xoa, Xu, Xu, Xoa, Xoa, Ql, Uu, Ql, Ql, Ql, Ql, Ql, Uh, Ql, Xu
Xu, Xu, Tb^Tf, Tb^Tf, Tb^Tf, Uu^Tf, Tb^Tf, Uu, Uu, Xu, Xuc^Efs, Xuc^Efs, Xu, Isa, Xu, Xu, Xu, Xu, Xu, Xu, Xu, Xu, Uh, Xoa, Xuc^Efs, Xu, Xu, Uh, Xu, Xu, Xu, Xoa, Xu, Qlf, Xu, Xu, Xu, Qxua, Qxua, Xu, Uu, Uu, Ql, Ql, Ql, Ql, Ql, Uu, Uu, Xu
Xu, Xu, Xoa, Xoa, Xoa, Xu, Uu^Edb, Isa, Uu, Xuc^Efs, Xuc^Efs, Uu, Uu^Emf, Xu, Xuc^Efs, Xu, Xuc^Efs, Xu, Xuc^Efs, Xu, Xu, Uh, Xoa, Xuc^Efs, Uu, Xuc^Efs, Xuc^Efs, Xu, Xu, Xu, Tb^Tf, Xu, Uu, Xu, Xu, Xu, Xu, Qxua, Xu, Qxua, Xu, Ql, Uu, Uu, Uu, Ql, Uu, Uu, Xu, Uu
Xu, Xoa, Xoa, Xoa, Xoa, Xoa, Isa^Edb, Isa^Emf, Isa, Xuc^Efs, Xu, Uu, Isa, Uu, Xuc^Efs, Xu, Uu^Edb, Xuc^Efs, Xoa, Xoa, Xoa, Xoa, Xuc^Efs, Tb^Tf, Tb^Tf, Uu, Xuc^Efs, Xu, Xu, Tb^Tf, Uu, Tb^Tf, Uh, Xu, Uh, Uh, Uh, Xu, Xu, Xu, Isa, Ql, Isa, Uh^Edt, Uh^Edt, Uh^Edt, Uh^Edt, Xu, Xu, Xu
Xu, Xoa, Xoa, Xoa, Xoa, Xoa, Xoa, Isa^Edb, Xoa, Xuc^Efs, Xu, Xu, Xuc^Efs, Uu, Xuc^Efs, Xu, Xoa, Uu, Uu, Uu^Edb, Xoa, Xoa, Xoa, Xuc^Efs, Uu, Xoa, Xoa, Xu, Xu, Xu, Xu, Xu, Qlf, Uh, Qlf, Xu, Uh, Uh, Ql, Ql, Ql, Ql, Xu, Xu, Xu, Xu, Xu, Xu, Xu, Xu
Xoa, Xoa, Xoa, Xoa, Xoa, Xoa, Xoa, Xoa, Xoa, Xoa, Xoa, Xuc^Efs, Xoa, Xuc^Efs, Xu, Xu, Xoa, Xoa, Uu, Uu^Edb, Xoa, Xoa, Xoa, Uu, Xoa, Xoa, Xuc^Efs, Xoa, Xu, Uh, Xu, Xoa, Xu, Qlf, Qlf, Xu, Xu, Ql, Xu, Uh, Uu, Xu, Uu, Isa, Isa, Uu, Xu, Uh^Edt, Xuc, Xu
Xoa, Xoa, Xoa, Xoa, Xuc^Efs, Xoa, Xoa, Xoa, Xoa, Uh, Uh, Xoa, Xuc^Efs, Xoa, Xoa, Xoa, Xu, Uu^Edb, Uu^Edb, Uu^Edb, Xoa, Xoa, Xoa, Xoa, Xoa, Xoa, Xoa, Uu, Uh, Uh, Xu, Xoa, Xu, Xu, Uh, Uh, Uu, Ql, Ql, Xu, Xu, Uu, Xu, Xu, Xu, Xu, Uh^Edt, Uh^Edt, Xuc, Xu
Xoa, Xu, Xoa, Xoa, Xuc^Efs, Xuc^Efs, Rb^Es, Rb^Es, Rb^Es, Rb^Es, Uh, Uh, Xuc^Efs, Xoa, Xoa, Xoa, Xoa, Xu, Xoa, Xoa, Xuc^Efs, Xu, Xu, Xu, Xoa, Xoa, Xoa, Xoa, Uu, Xu, Xu, Xu, Xu, Xu, Uu, Uh, Isa, Ql, Ql, Xu, Xu, Xu, Xu, Xu, Xu, Xuc, Rb^Edt, Rb^Edt, Xuc, Xu
Xoa, Xu, Xu, Xoa, Xoa, Xuc^Efs, Rb^Es, Rb^Es, Rb^Es, Uh, Uh, Xuc^Efs, Uh, Xoa, Xoa, Xoa, Xoa, Xu, Xu, Xu, Xu, Xu, Uu^Dr, Xu, Uu^Dr, Xoa, Xuc^Efs, Xuc^Efs, Xu, Xu, Uh, Xu, Xu, Isa, Isa, Isa^Ii, Isa, Ql, Ql, Xu, Xu, Xu, Xu, Uu^Edt, Uu^Edt, Xu^Edt, Rb^Edt, Xuc, Xu, Xu
Xu, Xoa, Xoa, Xu, Xoa, Rb^Es, Xu, Xoa, Xoa, Uh, Xoa, Rb^Es, Xoa, Xoa, Xoa, Xoa, Xoa, Xoa, Uu^Dr, Xu, Uu^Edb, Uu^Dr, Uu^Dr, Xu, Uu^Edb, Uu^Dr, Xu, Xu, Xoa, Xu, Xu, Xu, Ql, Ql, Ql, Isa, Ql, Ql, Xu, Ql, Xu, Xu, Xu, Xuc, Re^Edt, Re^Edt, Xu, Xu, Xu, Xu
Xu, Xoa, Uu, Xoa, Xoa, Xoa, Xu, Xu, Xu, Xoa, Xu, Xu, Xu, Xoa, Xu, Xu, Xoa, Xoa, Xu, Xu, Uu^Es, Rb^Es, Rb^Es, Uu^Edb, Re, Xu, Xu, Xu, Xoa, Xu, Rb^Es, Xoa, Ql, Xoa, Xoa, Ql, Xu, Xu, Xu, Xu, Xu, Xu, Uu^Edt, Xuc^Efs, Re^Edt, Xu, Xu, Xu, Xu, Xu
Xu, Xoa, Uu, Xoa, Xu, Xu, Xu, Xu, Uh, Xu, Xu, Xu, Xu, Xu, Rb^Es, Xoa, Rb^Es, Xoa, Uu^Edb, Qxua, Qxua, Uu^Es, Uu^Es, Re^Es, Qxua, Qxua, 3 Uu^Edb, Xu, Xoa, Xoa, Rb^Es, Rb^Es, Rb^Es, Rb^Es, Xoa, Xu, Xuc, Xu, Uu^Edt, Uu, Xuc, Xu, Xuc, Uu^Edt, Rb^Edt, Xuc^Efs, Uu, Xu, Xu, Xu
Xu, Xu, Xu, Xoa, Xu, Xu, Xu, Uu^Edt, Rb^Edt, Xu, Uh^Edt, Uh, Xu, Xoa, Xoa, Rb^Es, Xoa, Xoa, Xu, Qxua, Xoa, Uu, Re^Es, Re^Es, Xoa, Qxua, Xu, Xu, Xu, Xoa, Xoa, Rb^Es, Xoa, Xu, Xoa, Xu, Xuc, Uu^Edt, Re^Edt, Re, Xuc^Efs, Xu, Xu, Uu, Xuc, Re, Re^Edt, Xuc^Efs, Xu, Xu
Xu, Xu, Uh^Edt, Xu, Xuc^Efs, Xu, Xu, Rb, Xuc^Efs, Re, Uu^Edt, Uh^Edt, Xu, Xu, Xu, Rb^Es, Xoa, Xu, Xoa, Xoa, Gll, Re^Es, Re^Es, Re^Es, Gll, Xoa, Xu, Xu, Xu, Xu, Xu, Xoa, Xoa, Xoa, Xu, Xu, Xu, Uu^Edt, Xuc, Re, Re^Es, Xuc^Efs, Xu, Uu, Re^Es, Xuc^Efs, Xuc^Efs, Re, Gd, Xu
Xu, Xu, Xu, Uu^Edt, Rb^Edt, Xuc^Efs, Xuc^Efs, Xuc^Efs, Xuc^Efs, Re^Edt, Xuc^Efs, Xu, Xu, Xu, Xu, Xu, Xoa, Xoa, Xoa, Xoa, Gll^Fmw, Gd^Edt, Re, Gll, Re^Edt, Xoa, Aa^Fpa, Xu, Aa^Fpa, Xu, Xu, Xu, Xu, Xu, Xu, Xu, Xu, Xu, Xu, Re^Es, Xu, Gll, Re, Xu, Re^Edt, Gll^Edt, Re^Es, Re, Re^Edt, Xu
Xu, Uh^Edt, Uu^Edt, Re^Edt, Re, Xuc^Efs, Xuc^Efs, Re^Edt, Re^Edt, Re^Edt, Re^Edt, Xuc^Efs, Xu, Xu, Xu, Xu, Xu, Xu, Xuc^Efs, Xoa, Gll^Fmw, Re^Edt, Re, Gll^Efm, Re^Edt, Re^Edt, Aa^Fpa, Aa^Fpa, Aa^Fpa, Xuc^Efs, Xuc^Efs, Xu, Aa^Fda, Aa^Fpa, Aa^Fpa, Xu, Xu, Xu, Re, Re, Re^Edt, Xu, Re, Re^Edt, Re^Edt, Re^Es, Gll, Re^Edt, Aa^Fpa, Gll
Xu, Xu, Aa, Re^Es, Re^Es, Xu, Xu, Xu, Re^Edt, Re^Edt, Xuc^Efs, Xu, Xuc^Efs, Aa^Fpa, Aa^Fpa, Aa^Fda, Re^Edt, Xuc^Efs, Re^Edt, Re^Edt, Gd^Edt, Re^Edt, Re, Re^Edt, Gll^Edt, Gll^Fmw, Gll^Fmw, Re^Edt, Re^Edt, Re^Edt, Re^Edt, Re^Edt, Aa^Fmw, Aa^Fpa, Gll^Fmw, Xu, Xuc^Efs, Xuc^Efs, Re, Re^Edt, Re^Edt, Xuc^Efs, Re^Edt, Re, Re^Edt, Re^Edt, Aa^Fmw, Re^Edt, Aa^Fmw, Aa^Fpa
Aa^Fpa, Xu, Aa^Fpa, Re^Es, Re^Es, Gll, Aa, Re, Re^Edt, Re^Edt, Re^Edt, Xuc^Efs, Gll, Re^Edt, Aa^Fda, Aa^Fda, Re, Re^Edt, Gll^Fmw, Gll^Efm, 2 Ke, Re, Gll, Re, Re^Edt, Gll^Edt, Gll, Gll^Fmw, Re, Ce, Ce, Re^Edt, Gd^Fmw, Gll^Fmw, Aa^Fmw, Aa^Fmw, Aa^Fpa, Gd, Re^Edt, Re, Re, Re^Edt, Re^Edt, Gd, Aa, Re, Gll^Fmw, Gll^Fmw, Aa^Fmw, Aa^Fpa
Aa^Fpa, Aa^Fda, Gll^Fdw, Gll^Es, Re, Gll, Re, Re^Es, Re, Aa, Gll, Re^Edt, Aa, Re^Edt, Re, Re, Re, Gll^Fmw, Gll^Efm, Ce, Re^Vct, Ce, Re, Re^Edt, Re, Re^Edt, Re^Edt, Gll^Edt, Re^Es, Re^Es, Re, Ke, Gd^Es, Re, Aa, Aa^Fda, Gll, Aa^Fpa, Gll, Gll^Es, Re, Aa^Fda, Aa^Fmw, Aa^Fmw, Re^Es, Re, Gll^Edt, Aa^Fmw, Gll^Fmw, Aa^Fpa
Aa^Fpa, Aa^Fmw, Gll^Fmw, Gll^Fmw, Gll^Fmw, Re, Xu, Re^Es, Re, Re^Edt, Re, Gll^Fmw, Re, Re, Re, Ql, Re, Gll^Efm, Gd^Edt, Uu^Vds, Re^Es, Re, Re^Ecf, Re, Re, Re, Re, Re, Re, Re^Vct, Re, Ce, Re^Edt, Re, Re, Aa, Gd^Edt, Gll^Edt, Re^Edt, Re^Edt, Aa, Aa^Fmw, Aa^Fmw, Re, Re^Edt, Re^Edt, Re^Edt, Aa, Re, Aa
Aa^Fpa, Aa^Fmw, Aa^Fpa, Aa^Fmw, Aa^Fmw, Xu, Aa^Fpa, Xu, Gll, Re, Aa, Re, Re, Re, Re, Re, Re, Re, Re, Re, Re^Edt, Re^Es, Re, Re, Re, Re, Re, Re^Ecf, Re, Re, Re, Re^Edt, Re^Edt, Re, Re, Re^Edt, Re, Re^Edt, Re, Gd, Re^Edt, Re, Re, Re, Gll^Fmw, Re^Edt, Gd, Re^Edt, Re, Re
Aa^Fda, Aa^Fda, Aa, Xu, Xu, Aa^Fpa, Xu, Aa^Fpa, Xu, Xu, Aa, Gll^Fmw, Xu, Gd^Efm, Re, Re, Aa^Fpa, Aa^Fpa, Aa^Fpa, Gd^Edt, Ce, Re^Vct, Re^Vct, Re, Re, Re^Vct, Ce, Re, Re, Ce, Re^Edt, Re, Re, Re^Edt, Re, Aa, Aa^Fda, Gd, Ce, Re^Edt, Re^Ecf, Re^Es, Ce, Aa, Aa^Fmw, Aa^Fmw, Gll^Fmw, Gll, Re, Re^Es
Aa^Fpa, Aa^Fpa, Aa^Fpa, Xu, Xu, Xu, Aa^Fpa, Aa^Fpa, Xu, Xu, Xu, Aa, Aa^Fmw, Gll^Fdw, Re, Aa^Fpa, Aa^Fpa, Aa^Fda, Aa^Fpa, Re, Re, Ce, Ce, Re, Aa^Fda, Ce, Aa^Fda, Ce, Re^Edt, Re^Edt, Re, Re^Es, Re^Es, 1 Re, Re, Aa, Aa^Fda, Aa^Fpa, Ce, Re^Vct, Gll, Re^Vct, Aa^Fda, Aa^Fmw, Aa^Fmw, Aa^Fmw, Aa^Fmw, Aa, Aa, Gd
Aa^Fpa, Aa^Fpa, Aa^Fpa, Aa^Fda, Aa^Fda, Xu, Aa^Fda, Aa, Aa, Xu, Aa^Fpa, Aa^Fmw, Aa^Fmw, Gll^Fmw, Gd, Re, Gd, Aa^Fpa, Aa^Fpa, Aa^Fda, Aa^Fpa, Aa^Fpa, Aa^Fpa, Aa^Fda, Aa, Aa, Gd, Aa, Gd, Re, Aa^Fda, Gd, Gd^Es, Re^Es, Re, Re, Re, Aa, Aa, Aa, Aa, Ce, Aa^Fpa, Aa^Fda, Aa^Fpa, Aa^Fmw, Aa^Fpa, Aa^Fpa, Aa^Fpa, Aa
Aa^Fpa, Aa^Fpa, Aa^Fpa, Aa^Fpa, Aa^Fpa, Aa^Fpa, Aa^Fpa, Aa^Fpa, Aa^Fmw, Aa^Fpa, Aa^Fmw, Re, Aa^Fmw, Gll^Fmw, Gd, Re, Gd^Efm, Aa^Fpa, Aa^Fpa, Aa^Fpa, Aa, Aa^Fpa, Aa, Aa, Aa^Es, Aa^Es, Gd, Gd^Efm, Gd^Efm, Re, Re, Gd, Gd^Efm, Gd^Efm, Gll^Efm, Re, Re, Re, Gd, Re, Re, Aa^Fpa, Gd, Aa^Fpa, Aa^Fpa, Aa^Fpa, Gd, Gd, Gd, Gd
Aa^Fpa, Aa^Fpa, Aa^Fpa, Aa^Fpa, Aa^Fpa, Aa^Fpa, Aa^Fpa, Aa^Fpa, Aa^Fpa, Aa^Fpa, Aa^Fpa, Aa^Fmw, Aa^Fmw, Gll^Fmw, Gll^Fmw, Re, Gd^Efm, Aa^Fda, Aa^Fda, Aa^Fda, Aa^Fda, Aa^Fpa, Aa^Fda, Aa^Fpa, Aa^Fpa, Aa^Es, Aa^Fmw, Gd^Efm, Gd^Efm, Re, Re, Re, Re, Gd^Efm, Gll^Efm, Re^Es, Re^Es, Re^Es, Gll^Efm, Gll^Efm, Re, Aa, Aa^Es, Aa^Fpa, Aa^Fpa, Aa^Fpa, Gd^Es, Gd^Es, Aa^Fpa, Gd
Gll^Fmw, Gll^Fmw, Aa^Fpa, Aa^Fpa, Aa^Fpa, Aa^Fpa, Aa^Fpa, Aa^Fpa, Aa^Fda, Aa^Fpa, Aa^Fpa, Aa^Fmw, Aa^Fmw, Gll^Fmw, Gll^Efm, Re, Aa, Aa^Fda, Aa^Fpa, Aa^Fda, Aa^Fpa, Aa^Fda, Aa^Fpa, Aa^Fpa, Aa^Fmw, Aa^Fpa, Aa^Fmw, Aa, Gd^Efm, Gd^Efm, Gd, Gd, Aa^Fpa, Re, Re, Re, Re, Aa^Fpa, Aa^Fpa, Aa^Fpa, Re, Aa, Aa, Aa^Fpa, Aa^Fpa, Aa^Fpa, Aa^Fpa, Aa, Aa^Fpa, Aa^Fpa
Gll^Fmw, Gll^Fmw, Aa^Fpa, Aa^Fpa, Aa^Fda, Aa^Fda, Aa^Fda, Aa^Fda, Aa^Fda, Aa^Fda, Aa^Fmw, Aa^Fmw, Gll^Fmw, Gll^Efm, Re, Re, Aa, Aa^Es, Aa^Fmw, Aa^Fpa, Aa^Fmw, Aa^Fmw, Aa^Fpa, Aa^Fmw, Aa^Fmw, Aa^Fmw, Aa^Fmw, Aa, Gd, Aa^Fpa, Aa^Fpa, Aa^Fpa, Re, Re, Re, Aa^Fpa, Re, Re, Aa^Fpa, Aa^Fpa, Aa^Fpa, Re, Re, Re, Re^Es, Re, Re, Aa, Aa, Aa
Aa^Fmw, Gll^Fmw, Aa^Fda, Gll^Fmw, Gll^Fmw, Aa^Fda, Aa^Fmw, Aa^Fmw, Aa^Fda, Aa^Fda, Gll^Fmw, Aa^Fmw, Gll^Fmw, Re, Re, Aa^Es, Aa^Es, Aa^Es, Aa, Aa^Fmw, Aa, Aa^Fpa, Aa^Fmw, Aa^Fmw, Aa^Fmw, Aa^Fpa, Aa^Fmw, Aa, Aa^Fmw, Aa^Fpa, Gll^Fmw, Aa^Fpa, Re, Re^Es, Re^Es, Re^Es, Gd^Es, Gd, Aa, Aa^Fpa, Aa^Fpa, Aa^Fpa, Aa^Fpa, Aa^Fpa, Aa, Re^Es, Re, Re, Re, Aa^Fpa
Aa^Fpa, Aa^Fpa, Aa^Fda, Aa^Fda, Gd, Aa^Fmw, Re, Aa^Fmw, Gll^Fmw, Aa^Fda, Gll^Efm, Gd, Re, Re, Re, Re, Re, Aa^Es, Gd, Aa, Aa, Aa^Fpa, Aa^Es, Aa^Fmw, Aa^Fpa, Aa^Fpa, Aa^Fpa, Aa^Fmw, Gll^Fmw, Gll^Fmw, Gll^Fmw, Gd, Gd^Efm, Re, Re^Es, Re, Re, Aa^Fpa, Gd, Aa^Fpa, Aa^Fpa, Aa^Fpa, Aa^Fpa, Aa, Aa^Fpa, Gd, Aa^Fpa, Re, Re, Aa^Fpa
Gd, Aa, Aa, Aa^Fpa, Gd, Gll^Fmw, Re^Es, Re^Es, Re, Gll^Fmw, Gll^Efm, Gll^Efm, Re, Re, Aa, Gd, Aa^Fmw, Re, Re, Re, Re, Aa, Aa^Es, Aa^Es, Aa, Aa^Fda, Aa^Fda, Aa^Fpa, Gll^Fmw, Gll^Fmw, Gll^Fmw, Gd^Efm, Gd, Gd^Efm, Gd^Efm, Re^Es, Re, Re, Re, Aa^Fpa, Aa, Aa, Aa, Aa^Fpa, Aa^Fpa, Gd, Gd^Es, Gd^Es, Re^Es, Re
Aa, Aa, Aa^Fmw, Aa, Re^Es, Re^Es, Re^Es, Re, Gd, Re^Es, Re, Re, Gll^Fmw, Gll^Fmw, Aa, Gll^Fmw, Aa^Fmw, Aa^Fmw, Aa^Fpa, Re, Aa, Aa^Es, Aa^Fda, Aa, Xu, Xu, Xu, Aa^Fpa, Aa^Fpa, Gll^Fmw, Gll^Fmw, Aa^Fpa, Aa^Fpa, Aa^Fpa, Gd, Gd, Gd, Re, Re^Es, Gd^Efm, Gd^Efm, Gd^Efm, Aa^Fpa, Aa, Aa^Fpa, Gd, Aa^Fpa, Aa^Fpa, Gd, Re
Gll^Fmw, Gd, Gll^Fmw, Gd, Re^Es, Re^Es, Re^Es, Gd, Gll^Efm, Aa, Aa, Gll^Fmw, Aa^Fda, Aa^Fpa, Aa, Aa, Aa, Gll^Fmw, Aa^Fpa, Re, Re, Aa^Es, Aa, Xu, Xu, Xu, Xu, Aa^Fpa, Aa^Fpa, Xu, Xu, Aa^Fpa, Aa^Fpa, Gd, Aa^Fpa, Aa^Fpa, Gd, Re^Es, Re^Es, Gd, Aa, Aa^Fpa, Aa^Fpa, Aa^Fpa, Aa^Fpa, Aa^Fpa, Xu, Gd, Xu, Re
Gll^Fmw, Gll^Fmw, Aa^Fpa, Re, Re^Es, Re^Es, Gll^Efm, Gll^Efm, Aa, Aa^Fpa, Aa^Fda, Aa, Aa^Fpa, Aa^Fda, Aa^Fpa, Aa^Fda, Aa^Fpa, Aa^Fmw, Gll^Fmw, Re, Re, Re, Xu, Xu, Xu, Aa^Es, Xu, Xu, Gll^Fmw, Gll^Fmw, Xu, Gll^Fmw, Aa^Fpa, Aa^Fpa, Aa^Fpa, Aa^Fpa, Aa^Fpa, Re^Es, Re, Aa, Aa, Aa, Aa, Aa^Fpa, Aa, Aa^Fpa, Xu, Xu, Xu, Xu
Aa^Fpa, Aa^Fpa, Aa^Fpa, Re, Re, Re, Gll^Efm, Gll^Efm, Aa^Fpa, Aa^Fpa, Aa^Fpa, Aa^Fpa, Aa^Fpa, Aa^Fpa, Aa^Fpa, Aa^Fpa, Aa^Fpa, Gll^Fmw, Gd, Aa^Fpa, Re, Re, Aa^Fpa, Xu, Xu, Xu, Xu, Xu, Xu, Aa^Fpa, Gll^Fmw, Aa^Fpa, Aa^Fpa, Aa^Fpa, Aa^Fpa, Aa^Fpa, Aa^Fpa, Re, Re, Aa^Fpa, Aa^Fpa, Aa^Fpa, Aa^Fpa, Aa, Aa^Fpa, Xu, Xu, Xu, Xu, Xu
