Qxua, Qxua, Qxua, Qxua, Qxua, Gll^Fmw, Qxua, Qxua, Qxua, Qxua, Qxua, Qxua, Qxua, Qxua, Qxua, Qxua, Qxua, Qxua, Qxua, Qxua, Qxua, Qxua, Qxua, Qxua, Qxua, Gs^Fms, Qxua, Gs^Fms, Qxua, Gs^Fms, Gs^Fms, Gs^Fms, Qxua, Gll^Fmw
Qxua, Qxua, Gs^Fms, Qxua, Qxua, Gs^Fms, Qxua, Qxua, Gs^Fms, Gll^Es, Gll^Es, Qxua, Gll^Edb, Qxua, Qxua, Qxua, Qxua, Qxua, Qxua, Qxua, Qxua, Qxua, Qxua, Qxua, Wwf, Qxua, Qxua, Qxua, Gs^Fms, Qxua, Qxua, Qxua, Qxua, Gll^Fmw
Qxua, Qxua, Qxua, Qxua, Qxua, Qxua, Qxua, Gs^Fms, Gd^Es, Gd, Gll^Fp, Gll, Gd^Edb, Qxua, Gll^Fmw, Qxua, Qxua, Qxua, Gll^Fmw, Qxua, Qxua, Gll^Fp, Gll^Fmw, Gll^Fdw, Wwf, Gll^Fdw, Wwf, Wwf, Wwf, Gs^Fms, Qxua, Qxua, Qxua, Gll^Fmw
Qxua, Qxua, Qxua, Qxua, Wwf, Qxua, Qxua, Qxua, Gs^Fms, Gd, Gs^Fms, Gll^Fmw, Gll^Fdw, Qxua, Qxua, Qxua, Gll^Fdw, Gll^Fdw, Gll^Fdw, Gll^Fdw, Qxua, Qxua, Gll^Fdw, Gll^Fdw, Wwf, Wwf, Wwf, Wwf, Gll^Fdw, Qxua, Qxua, Qxua, Qxua, Gll^Fmw
Qxua, Qxua, Gll^Fmw, Qxua, Wwf, Qxua, Gll^Es, Gs^Es, Gs^Es, Gs^Es, Gll^Fmw, Gll^Fdw, Cvr^Fmw, Qxua, Qxua, Qxua, Qxua, Qxua, Qxua, Gll^Fmw, Gll^Fmw, Gll^Fmw, Qxua, Wwf, Chr^Fmw, Chr^Fmw, Chr^Es, Gll^Fmw, Gll^Fmw, Qxua, Gll^Fmw, Gll^Fmw, Qxua, Gs^Fms
Qxua, Qxua, Qxua, Gll^Fmw, Gll^Fdw, Wwf, Wwf, Wwf, Wwf, Gll^Fmw, Chr^Fmw, Gll^Fmw, Qxua, Cvr^Fdw, Qxua, Qxua, Qxua, Qxua, Gll^Em, Gll^Em, Gll^Fmw, Qxua, Qxua, Qxua, Qxua, Qxua, Qxua, Qxua, Gll^Es, Gll^Es, Gs^Fms, Gs^Fms, Qxua, Qxua
Qxua, Qxua, Qxua, Gll^Fmw, Gll^Fdw, Gll^Fetd, Qxua, Qxua, Qxua, Qxua, Gll^Fmw, Gll^Fmw, Qxua, Qxua, Qxua, Qxua, Gll^Em, Qxua, Qxua, Qxua, Gll, Gll^Em, Gll, Qxua, Qxua, Qxua, Qxua, Qxua, Qxua, Gs^Fms, Gs^Fms, Gll, Qxua, Qxua
Gll^Fmw, Qxua, Gll^Fmw, Gll^Es, Qxua, Qxua, Qxua, Gll^Fmw, Qxua, Qxua, Qxua, Gll^Fmw, Qxua, Qxua, Cvr^Es, Qxua, Qxua, Qxua, Qxua, Qxua, Gd^Edb, Gd, Gll^Fmw, Qxua, Cvr, Gll^Em, Qxua, Qxua, Qxua, Cvr^Fms, Qxua, Gll, Gll, Gs^Fms
Gll^Fmw, Qxua, Gs^Fms, Cvr^Fmw, Qxua, Qxua, Qxua, Qxua, Gll^Es, Gll^Em, Gll^Em, Gll^Em, Qxua, Qxua, Qxua, Gd^Es, Gd^Es, Qxua, Gd^Es, Gd, Gd^Edb, Gd^Edb, Gd, Gll^Es, Qxua, Qxua, Qxua, Qxua, Qxua, Qxua, Gd, Gd, Gll^Es, Gs^Fms
Qxua, Qxua, Gs^Fms, Cvr^Fmw, Qxua, Gll^Es, Isa^Es, Gd^Fetd, Isa^Es, Gd, Gd^Edb, Gll^Fdw, Wwf, Qxua, Gd^Es, Gd^Es, Gd^Es, Gd^Es, Gd^Edb, Gd^Edb, Gd^Edb, Gd^Edb, Qxua, Gll^Es, Gll^Es, Qxua, Qxua, Qxua, Qxua, Qxua, Qxua, Gll, Gll^Fdw, Gll^Fdw
Qxua, Qxua, Qxua, Qxua, Qxua, Isa^Es, Cvr^Es, Isa, Isa^Es, Gd^Edb, Wwf, Gd^Edb, Wwf, Gd, Gll, Qxua, Gd^Fetd, Isa, Gd^Edb, Isa, Gll, Qxua, Qxua, Qxua, Qxua, Gd^Fetd, Qxua, Qxua, Qxua, Qxua, Wwf, Gs^Fms, Gll^Fdw, Gll^Fmw
Gll^Fmw, Gll^Fdw, Qxua, Qxua, Gll^Fetd, Qxua, Qxua, Qxua, Qxua, Qxua, Qxua, Wwf, Qxua, Gll, Gll, Gll, Gd^Ebn, Isa^Edb, Isa^Edb, Isa^Edb, Gll^Ebn, Qxua, Qxua, Qxua, Isa, Isa, Isa^Em, Qxua, Qxua, Gs^Fms, Gs^Fetd, Wwf, Wwf, Gll^Fmw
Gll^Fmw, Qxua, Gs^Fms, Gs^Fdw, Wwf, Wwf, Qxua, Qxua, Qxua, Qxua, Isa, Qxua, Gd, Gd^Edb, Gll^Ebn, Gll^Edb, Isa^Edb, Isa^Edb, 2 Isa^Edb, Isa^Edb, Isa^Edb, Isa, Gd^Ebn, Gd, Isa^Edb, Isa^Em, Qxua, Qxua, Qxua, Qxua, Cvr, Wwf, Qxua, Gs^Fms
Gll^Fmw, Gll^Fmw, Qxua, Qxua, Qxua, Qxua, Isa^Em, Qxua, Qxua, Isa, Isa^Es, Isa^Es, Isa^Es, Gd^Es, Gd, Isa^Edb, Isa^Edb, Isa^Edb, Isa^Edb, Isa^Edb, Isa^Edb, Isa, Isa^Edb, Isa^Edb, Isa^Edb, Qxua, Qxua, Qxua, Qxua, Qxua, Cvr, Cvr^Fms, Qxua, Qxua
Gll^Fmw, Qxua, Qxua, Qxua, Qxua, Qxua, Isa^Em, Qxua, Qxua, Cvr, Isa^Es, Isa^Es, Isa^Es, Gll^Es, Gll^Es, Gll^Edb, Gll^Edb, Isa^Edb, Isa^Edb, Isa^Edb, Isa^Edb, Isa^Edb, Isa^Edb, Isa^Edb, Isa, Isa^Edb, Isa^Em, Qxua, Qxua, Qxua, Qxua, Qxua, Qxua, Qxua
Gll^Fmw, Gll^Fmw, Gll^Fmw, Gll^Fmw, Gll^Fmw, Qxua, Qxua, Cvr, Qxua, Qxua, Isa^Es, Gll^Es, Gd^Edb, Gll^Es, Gd^Es, Isa, Isa^Edb, Isa^Edb, 1 Isa^Edb, Isa^Edb, Isa^Edb, Isa^Edb, Isa^Edb, Isa^Es, Isa, Qxua, Cvr, Cvr^Em, Qxua, Qxua, Qxua, Qxua, Qxua, Gll^Fmw
Gs^Fms, Gll^Fmw, Gll^Fdw, Gll^Fmw, Gll^Fmw, Qxua, Qxua, Qxua, Isa, Isa, Qxua, Gd, Gd^Es, Gd^Edb, Gd^Edb, Gd^Edb, Gd^Edb, Gd^Edb, Isa, Isa^Edb, Isa^Edb, Isa^Edb, Isa^Edb, Isa^Es, Isa^Es, Isa, Qxua, Qxua, Qxua, Qxua, Qxua, Qxua, Qxua, Gll^Fmw
Gll^Fmw, Gs^Fdw, Gs^Fmw, Gll^Fetd, Gll^Fmw, Qxua, Qxua, Qxua, Isa^Em, Isa, Qxua, Gd^Fetd, Gd^Es, Gd^Edb, Gd^Edb, Gd, Gll^Edb, Gd^Edb, Gll^Edb, Isa, Isa, Isa^Es, Wwf, Wwf, Qxua, Isa, Isa^Em, Cvr^Em, Qxua, Qxua, Qxua, Qxua, Qxua, Qxua
Gll^Fmw, Gs^Fmw, Gs^Fmw, Gll^Fmw, Cvr^Es, Qxua, Cvr^Fmw, Qxua, Qxua, Qxua, Qxua, Qxua, Qxua, Qxua, Qxua, Gd^Edb, Gll, Gll^Edb, Gd, Gd, Gll^Edb, Gd^Edb, Wwf, Qxua, Qxua, Isa^Em, Qxua, Qxua, Qxua, Qxua, Qxua, Cvr^Es, Gs^Es, Gll^Fmw
Gll^Fp, Gll^Fmw, Gll^Fmw, Gs^Fms, Isa, Cvr^Fmw, Qxua, Qxua, Qxua, Gll^Em, Qxua, Gll, Gll, Qxua, Qxua, Qxua, Gll^Edb, Qxua, Gll, Gll^Edb, Gll, Gd, Qxua, Wwf, Qxua, Qxua, Qxua, Qxua, Qxua, Qxua, Qxua, Cvr^Es, Qxua, Qxua
Gs^Fms, Qxua, Qxua, Isa, Isa, Wwf, Qxua, Qxua, Qxua, Qxua, Qxua, Qxua, Gll^Em, Gll, Gll^Es, Gll^Edb, Gll^Es, Gll^Edb, Gll, Qxua, Gll, Qxua, Qxua, Qxua, Qxua, Qxua, Qxua, Qxua, Gs^Fms, Gs^Fdw, Qxua, Qxua, Qxua, Qxua
Gs^Fms, Qxua, Wwf, Wwf, Wwf, Wwf^Es, Gll^Fmw, Qxua, Gll^Fdw, Qxua, Qxua, Qxua, Qxua, Gll^Es, Qxua, Gll^Edb, Qxua, Gll, Gll^Edb, Gll^Em, Qxua, Qxua, Qxua, Qxua, Gll^Fdw, Gll^Fdw, Qxua, Qxua, Qxua, Qxua, Qxua, Qxua, Qxua, Qxua
Qxua, Qxua, Qxua, Gll^Fmw, Gll^Fdw, Gll^Fdw, Gll^Fmw, Gll^Fmw, Gll^Fmw, Gs^Es, Qxua, Qxua, Qxua, Qxua, Qxua, Qxua, Gll^Es, Qxua, Qxua, Gll^Edb, Qxua, Qxua, Qxua, Gll^Fdw, Gs^Fetd, Gs^Fms, Qxua, Qxua, Qxua, Qxua, Qxua, Qxua, Qxua, Qxua
Qxua, Gs^Fms, Gs^Fms, Gs^Fms, Gll^Fdw, Qxua, Gs^Fmw, Isa, Isa^Edb, Qxua, Cvr^Fmw, Cvr^Fmw, Isa^Edb, Gll^Fmw, Gll^Fmw, Qxua, Gll^Fmw, Cvr^Fmw, Cvr^Es, Gll^Edb, Qxua, Qxua, Qxua, Cvr^Fms, Gs^Fms, Qxua, Gs^Fds, Qxua, Qxua, Qxua, Gll, Qxua, Gll, Qxua
Qxua, Gs^Fms, Qxua, Gs^Fms, Gs^Fms, Qxua, Qxua, Gs^Fmw, Isa, Isa, Gll^Fmw, Cvr^Fmw, Isa^Edb, Isa, Gll^Fp, Gll^Fmw, Gll^Es, Gll^Fmw, Cvr^Fms, Qxua, Qxua, Gll^Edb, Gs^Fms, Cvr^Fms, Qxua, Qxua, Gs^Fms, Gs^Fetd, Gs^Fms, Gs^Fms, Qxua, Qxua, Gll^Es, Qxua
Qxua, Qxua, Qxua, Qxua, Qxua, Qxua, Qxua, Gs^Fms, Qxua, Gs^Fms, Qxua, Gll^Fmw, Gll^Fmw, Gll^Fmw, Gs^Fms, Gs^Fetd, Gs^Fms, Gs^Fms, Qxua, Gs^Fms, Cvr^Fms, Gll^Edb, Gs^Fms, Qxua, Gs^Fms, Gs^Fms, Gs^Fms, Gll^Es, Gll, Qxua, Qxua, Gll^Es, Qxua, Gs^Fms
Qxua, Qxua, Qxua, Qxua, Qxua, Qxua, Gs^Fms, Gs^Fms, Qxua, Qxua, Gs^Fms, Qxua, Gd, Gs^Fms, Gll, Gs^Fms, Gd, Gs^Fms, Qxua, Qxua, Gs^Fms, Qxua, Qxua, Qxua, Qxua, Qxua, Qxua, Gs^Fms, Qxua, Qxua, Qxua, Qxua, Qxua, Qxua
Qxua, Qxua, Qxua, Qxua, Qxua, Qxua, Qxua, Qxua, Qxua, Qxua, Gs^Fms, Gd, Gs^Fms, Gd, Gll^Fp, Gll, Gd, Qxua, Gs^Fms, Qxua, Qxua, Qxua, Qxua, Qxua, Qxua, Qxua, Gs^Fms, Qxua, Qxua, Qxua, Qxua, Qxua, Qxua, Qxua
