Qxua, Qxua, Qxua, Qxua, Qxua, Qxua, Gll^Fmw, Qxua, Qxua, Qxua, Qxua, Qxua, Xu, Xu, Xu, Qxua, Xu, Xu, Qxua, Qxua, Xu, Xu, Xu, Xu, Xu, Gll^Fmw, Uu, Uu, Re, Uu, Uh, Uu, Uu, Uu
Qxua, Qxua, Gll^Fmw, Gll^Fmw, Gll^Fmw, Gll^Fmw, Qxua, Gll^Fmw, Qxua, Qxua, Qxua, Qxua, Qxua, Xu, Qxua, Qxua, Cud, Xu, Qxua, Qxua, Xu, Xu, Cde, Cde, 3 Kde, Gll^Fmw, Uh, Re, Re^Es, Re^Es, Uh, Uh, Xu, Xu
Qxua, Qxua, Qxua, Qxua, Qxua, Qxua, Qxua, Qxua, Qxua, Qxua, Qxua, Uh, Xu, Qxua, Xu, Qxua, Xu, Xu, Xu, Xu, Cud, Xu, Xu, Cde, Cde, Cde, Isa, Uu^Es, Re^Es, Re^Es, Uu^Ve, Gll^Fmw, Xu, Xu
Qxua, Xu, Qxua, Qxua, Uh, Uh, Uh, Gll^Fmw, Xu, Xu, Xu, Qxua, Xu, Xu, Gll^Fmw, Gll^Fdw, Gll^Fmw, Qxua, Qxua, Xu, Qxua, Xu, Uh, Gll^Fdw, Uh, Isa, Isa, Re, Gd^Fetd, Re, Xu, Gll^Fmw, Xu, Xu
Xu, Xu, Xu, Qxua, Cde, Uu^Ve, Re, Gll^Fdw, Xu, Xu, Gll^Ve, Xu, Qxua, Qxua, Qxua, Xu, Qxua, Qxua, Isa, Qxua, Isa, Qxua, Qxua, Uh, Re^Es, Re^Es, Uu^Em, Re^Es, Gll^Fdw, Uu, Xu, Xu, Xu, Uu
Xu, Xu, Xu, Xu, 2 Kde, Cde, Isa, Re, Re, Gll^Fmw, Uu, Qxua, Qxua, Qxua, Qxua, Isa, Uu, Qxua, Uu, Qxua, Uu, Qxua, Qxua, Re^Ve, Re^Es, Re, Qxua, Uu^Es, Gll^Fdw, Uu^Es, Uu^Ve, Xu, Xu, Uu
Xu, Xu, Xu, Xu, Cde, Isa, Qxua, Qxua, Re, Re^Es, Uu, Qxua, Tb^Tf, Gd^Fetd, Gll^Fdw, Qxua, Isa, Tb^Tf, Isa, Gll^Fmw, Gll^Fmw, Gll^Fdw, Re^Es, Uu^Es, Uu, Qxua, Qxua, Qxua, Qxua, Qxua, Qxua, Gll^Fmw, Xu, Xu
Xu, Xu, Xu, Qxua, Qxua, Cde, Qxua, Xu, Uu, Re^Es, Re^Es, Re, Re^Em, Uu^Em, Uu, Gll^Fdw, Re^Es, Isa, Isa, Uu, Xu, Gll^Fdw, Re^Es, Re^Es, Re^Em, Uu, Gll^Fdw, Uu, Isa, Qxua, Qxua, Gll^Fdw, Gll^Fmw, Xu
Qxua, Uh, Qxua, Xu, Qxua, Qxua, Xu, Xu, Tb^Tf, Re, Re, Re^Es, Uu, Re, Re, Re^Es, Uu, Re^Es, Uu, Re, Uh, Gll^Fmw, Uu, Re^Em, Re^Em, Gll^Fmw, Gll^Fdw, Qxua, Qxua, Qxua, Qxua, Qxua, Qxua, Uu
Qxua, Qxua, Qxua, Xu, Xu, Xu, Uh, Xu, Xu, Tb^Tf, Xot, Uu^Ve, Xu, Uu, Xu, Qxua, Qxua, Qxua, Qxua, Qxua, Uh^Tf, Uh, Re, Re^Es, Re^Em, Uh, Uh^Tf, Qxua, Xu, Qxua, Cde, Qxua, 4 Kde, Qxua
Qxua, Qxua, Qxua, Qxua, Uu, Qxua, Qxua, Xu, Cfr, Xu, Xu, Xot, Xu, Qxua, Xu, Qxua, Qxua, Qxua, Xot, Qxua, Isa, Re, Uh, Re^Es, Gll^Fdw, Uh, Qxua, Xot, Xot, Uu, Uh, Cde, Qxua, Qxua
Qxua, Qxua, Qxua, Uu, Re, Qxua, Qxua, Qxua, Xot, Xu, Re^Es, Re^Es, Xot, Xu, Qxua, Uu, Xot, Gll^Fmw, Isa^Ebn, Isa, Xot, Uu, Qxua, Uu, Gll^Fdw, Gll^Fmw, Xot, Qxua, Uu, Re, Gll^Fmw, Cde, Qxua, Qxua
Qxua, Qxua, Qxua, Tb^Tf, Uu, Qxua, Qxua, Uh, Uh, Re, Uu, Re^Es, Uu, Xu, Qxua, Qxua, Isa, Isa, Isa, Isa, Xot, Xot, Qxua, Gll^Fmw, Gll^Fmw, Xot, Xu, Re^Es, Re^Es, Re^Es, Gll^Fdw, Qxua, Qxua, Qxua
Qxua, Qxua, Qxua, Qxua, Qxua, Xu, Uu, Uh, Gll^Fdw, Uu, Qxua, Uu, Qxua, Qxua, Qxua, Gll^Fmw, Isa, Isa, Xot, Isa, Qxua, Qxua, Qxua, Qxua, Qxua, Xot, Xu, Xu, Uu, Re^Es, Gll^Fdw, Gll^Fmw, Qxua, Qxua
Qxua, Qxua, Gll^Fmw, Qxua, Gll^Fdw, Qxua, Uu, Gll^Fdw, Gll^Fdw, Gll^Fmw, Qxua, Qxua, Gd^Fetd, Uu^Ve, Isa, Isa, Isa, Isa, Isa^Ebn, Qxua, Qxua, Qxua, Qxua, Qxua, Uu, Xu, Xu, Xu, Xu, Re^Es, Re^Ve, Gll^Fdw, Qxua, Qxua
Qxua, Qxua, Qxua, Gll^Fdw, Qxua, Qxua, Qxua, Gll^Fmw, Qxua, Qxua, Qxua, Gll^Fmw, Uu, Uu, Re, Isa, Uu, Isa, Uh, Xu, Uu, Gll^Fmw, Qxua, Qxua, Re, Re^Es, Re^Es, Qxua, Qxua, Uu, Uh, Gll^Fmw, Qxua, Qxua
Qxua, Qxua, Qxua, Gll^Fmw, Gll^Fdw, Qxua, Qxua, Qxua, Qxua, Qxua, Qxua, Qxua, Re, Re^Es, Xu, Xu, Xu, Uu, Gll^Fmw, Gd^Fetd, Uu, Qxua, Qxua, Uh^Tf, Isa, Xu, Xu, Qxua, Qxua, Qxua, Xu, Xu, Xu, Qxua
Qxua, Qxua, Qxua, Qxua, Qxua, Qxua, Isa, Qxua, Qxua, Qxua, Qxua, Uh, Re^Es, Uu, Xu, Cfr, Qxua, Uu, Qxua, Gll^Fmw, Qxua, Isa, Qxua, Qxua, Xu, Isa, Xu, Uu, Qxua, Qxua, Xu, Cud, Qxua, Qxua
Qxua, Qxua, Qxua, Qxua, Qxua, Qxua, Qxua, Qxua, Gll^Fdw, Qxua, Qxua, Re, Re^Es, Xu, Xu, Qxua, Qxua, Isa, Qxua, Qxua, Gll^Fmw, Qxua, Uh, Uh^Tf, Re, Isa, Xu, Xu, Qxua, Uh^Tf, Qxua, Qxua, Gll^Ve, Gll^Fmw
Qxua, Qxua, Qxua, Qxua, Qxua, Qxua, Qxua, Tb^Tf, Gll^Fmw, Gll^Fdw, Re, Uu, Re^Es, Uh^Tf, Uh, Xu, Uu, Qxua, Re^Es, Gll^Fmw, Re^Es, Re^Ve, Re^Es, Re^Es, Re^Es, Re^Es, Re, Qxua, Qxua, Isa, Isa, Qxua, Gll^Fmw, Qxua
Qxua, Qxua, Qxua, Qxua, Qxua, Qxua, Qxua, Tb^Tf, Qxua, Re, Gll^Fmw, Re, Xu, Re^Es, Re^Es, Re, Gll^Fmw, Gll^Fdw, Gll^Fdw, Re^Es, Qxua, Re^Es, Re, Uu, Xu, Xu, Re^Es, Isa, Xu, Xu, Xu, Qxua, Qxua, Qxua
Qxua, Qxua, Gll^Fmw, Qxua, Qxua, Isa, Qxua, Uu, Uh, Qxua, Gll^Fdw, Xu, Xu, Uu^Ve, Gll^Fmw, Re^Es, Re, Uu, Uu, Qxua, Re^Es, Re^Es, Tb^Tf, Gd^Fetd, Xu, Xu, Isa, Re^Es, Isa, 5 Cud, Isa, Qxua, Qxua, Qxua
Gll^Fmw, Gll^Fmw, Gll^Fmw, Gll^Fmw, Qxua, Qxua, Qxua, Qxua, Qxua, Uh, Gll^Fmw, Xu, Xu, Xu, Gll^Fdw, Uu, 1 Re^Es, Re^Es, Re^Es, Re, Cud, Re, Qxua, Xu, Cud, Xu, Xu, Uu, Qxua, Isa, Isa, Isa, Qxua, Qxua
Qxua, Qxua, Qxua, Qxua, Qxua, Qxua, Qxua, Qxua, Qxua, Qxua, Uh, Qxua, Xu, Gll^Ve, Gll^Fdw, Re, Re^Es, Uu, Gll^Fdw, Cud, Kud, Qxua, Gll^Fmw, Gll^Fdw, Gll^Fdw, Xu, Cud, Xu, Isa, Isa, Isa, Isa, Qxua, Qxua
Qxua, Qxua, Qxua, Qxua, Qxua, Qxua, Qxua, Qxua, Qxua, Qxua, Qxua, Qxua, Qxua, Xu, Uu, Re, Re, Re, Gll^Fmw, Cud, Xu, Xu, Xu, Qxua, Qxua, Gll^Fmw, Qxua, Xu, Qxua, Qxua, Qxua, Uu, Qxua, Qxua
Qxua, Qxua, Qxua, Qxua, Qxua, Qxua, Qxua, Qxua, Qxua, Qxua, Qxua, Qxua, Qxua, Qxua, Re^Es, Uu, Re^Es, Re^Es, Qxua, Uu, Uu, Xu, Qxua, Qxua, Qxua, Qxua, Qxua, Qxua, Qxua, Qxua, Qxua, Qxua, Qxua, Qxua
