Uu, Uu, Re, Uu, Gll^Fdw, Gll^Fdw, Cde, Cde, Cde, Uu, Xu, Xu, Xu, Xu, Xu, Xu, Xu, Xu, Xu, Xu, Xu, Xu, Xu, Qxua, Xu, Qxua, Qxua, Qxua, Qxua, Qxua, Qxua, Qxua, Qxua, Qxua, Qxua, Qxua, Qxua, Qxua, Qxua, Qxua, Qxua, Qxua, Qxua, Qxua, Qxua, Qxua, Qxua, Qxua, Qxua, Qxua, Qxua, Qxua, Qxua
Gll^Fdw, Re, Uu, Re^Es, Re^Edb, Gll^Fdw, Cde, 2 Kde, Cde, Cde, Isa^Edb, Isa, Gll^Fdw, Xu, Uh, Xu, Uh^Emf, Xu, Xu, Xot, Xot, Xu, Uu^Edb, Uu, Gll^Fdw, Gll^Fdw, Qxua, Qxua, Qxua, Qxua, Uu, Qxua, Uu, Qxua, Qxua, Qxua, Qxua, Qxua, Qxua, Qxua, Qxua, Qxua, Qxua, Qxua, Qxua, Qxua, Qxua, Qxua, Qxua, Qxua, Qxua, Qxua, Qxua
Gll^Fdw, Gll^Fmw, Gll^Fdw, Re^Edb, Re^Edb, Uu^Edb, Isa^Es, Cde, Re, Isa, Isa^Edb, Isa^Edb, Gll^Ve, Gll^Fmw, Gll^Fmw, Uh^Em, Cde, Xu, Xot, Xot, Uu^Edb, Xot, Xu, Uu, Qxua, Qxua, Qxua, Qxua, Uh, Qxua, Qxua, Qxua, Qxua, Qxua, Uh, Qxua, Isa, Qxua, Qxua, Qxua, Qxua, Qxua, Uu, Qxua, Qxua, Qxua, Qxua, Qxua, Qxua, Qxua, Qxua, Qxua, Qxua
Xu, Uu, Uu^Edb, Uu^Edb, Gll^Fdw, Uu^Edb, Re^Edb, Re^Es, Re^Es, Isa, Re^Es, Re, Gll^Fdw, Gll^Fmw, Uh^Edb, Uu^Em, Cde, Cde, Xu, Xot, Xot, Qxua, Qxua, Qxua, Uh, Uh^Emf, Uh^Emf, Uh^Em, Re^Em, Re, Uu^Ve, Gll^Fmw, Gll^Fmw, Uh, Qxua, Uu, Isa, Isa, Uh, Qxua, Uh, Qxua, Qxua, Qxua, Uu, Qxua, Qxua, Qxua, Qxua, Qxua, Qxua, Qxua, Qxua
Cde, Xu, Cde, Uu^Ebn, Gll^Fmw, Uu^Edb, Re^Edb, Re^Edb, Re, Uu, Re^Es, Uu, Uu, Uu^Ebn, Uu, Uu^Edb, Qxua, Xoa, Xot, Xot, Qxua, Qxua, Uu, Qxua, Uu^Edb, Qxua, Qxua, Uu^Em, Re, Re^Es, Re^Es, Uu, Re, Gll^Fmw, Re, Qxua, Re^Es, Uu^Em, Gll^Fmw, Uh^Emf, Gll^Fmw, Qxua, Qxua, Qxua, Qxua, Qxua, Uu, Qxua, Qxua, Qxua, Qxua, Qxua, Qxua
Xu, Cde, Cde, Gll^Fmw, Gll^Ve, Re, Re^Edb, Uu^Es, Re^Em, Re^Es, 1 Re^Es, Uh, Uh, Qxua, Qxua, Xu, Xu, Xoa, Re, Qxua, Uu, Uu, Qxua, Re^Edb, Re^Edb, Re, Re, Re, Qxua, Uu^Ebn, Isa, Qxua, Isa, Isa^Es, Isa, Uu, Re^Es, Re^Em, Gll^Fdw, Gll^Fmw, Gll^Fdw, Gll^Fmw, Gll^Fmw, Uh^Emf, Uh^Em, Qxua, Qxua, Qxua, Qxua, Qxua, Qxua, Qxua, Qxua
Xu, Xu, Xu, Gll^Fmw, Gll^Fmw, Gll^Fdw, Uh^Emf, Re^Em, Uh^Em, Re^Es, Re^Es, Uu, Xu, Uu, Re, Uu, Re, Uu^Ebn, Re, Re, Uu, Uu, Re, Re^Es, Xu, Re^Es, Qxua, Qxua, Qxua, Qxua, Qxua, Isa, Qxua, Isa, Isa, Re, Gll^Fdw, Re^Es, Re, Re, Re, Gll^Fdw, Uu^Ve, Gll^Fdw, Gll^Fdw, Uu, Re, Uh, Qxua, Qxua, Qxua, Qxua, Qxua
Qxua, Xu, Xu, Xu, Xu, Uh^Emf, Xu, Uh^Emf, Uh^Emf, Uu, Re, Re^Es, Re^Es, Xu, Re^Es, Re, Uu, Re, Uu, Uu, Qxua, Xu, Xu, Xu, Xu, Xu, Xu, Xu, Xu, Gll^Fdw, Qxua, Qxua, Qxua, Qxua, Isa, Isa, Uu, Gll^Fdw, Qxua, Uu, Qxua, Re, Qxua, Uu, Xu, Xu, Uu, Re, Re, Uh, Uh, Qxua, Qxua
Qxua, Xu, Xu, Xu, Xu, Xu, Xu, Xu, Xu, Xu, Gll^Fdw, Re, Gll^Ve, Re^Es, Uu, Isa, Isa, Uu, Xu, Uu, Xu, Qxua, Qxua, Qxua, Xu, Xu, Qxua, Uu, Xu, Gll^Fdw, Gll^Fmw, Gll^Fmw, Qxua, Xu, Qxua, Qxua, Qxua, Cde, Kde, Uu, Qxua, Re, Gll^Fdw, Re, Xot, Xu, Xu, Xu, Re, Qxua, Uh, Qxua, Qxua
Uh, Qxua, Qxua, Xu, Uh, Uh^Emf, Uh^Emf, Xu, Uu, Gll^Fdw, Gll^Fdw, Gll^Fdw, Qxua, Qxua, Qxua, Qxua, Xu, Xu, Qxua, Xu, Xu, Qxua, Uu, Qxua, Gll^Fdw, Uu, Xu, Qxua, Qxua, Qxua, Qxua, Qxua, Qxua, Qxua, Qxua, Qxua, Qxua, Qxua, Qxua, Uu, Gll^Fmw, Re, Re, Re^Ebn, Uu, Xot, Xu, Xu, Re, Uh, Qxua, Qxua, Qxua
Xu, Uh, Qxua, Qxua, Qxua, Qxua, Qxua, Uh^Em, Qxua, Gll^Fdw, Qxua, Qxua, Qxua, Qxua, Qxua, Qxua, Qxua, Qxua, Qxua, Uh, Re, Xu, Qxua, Gll^Fdw, Qxua, Qxua, Uu, Qxua, Qxua, Qxua, Xu, Xu, Qxua, Qxua, Qxua, Qxua, Qxua, Qxua, Qxua, Xu, Xu, Uu, Re^Es, Uu, Xot, Xu, Xu, Xu, Uu, Uh, Qxua, Qxua, Qxua
Qxua, Uh, Xu, Qxua, Uh, Qxua, Qxua, Qxua, Qxua, Gll^Fdw, Qxua, Qxua, Qxua, Qxua, Qxua, Qxua, Re^Em, Uh^Emf, Qxua, Qxua, Re^Em, Xu, Xu, Qxua, Xu, Xu, Qxua, Uu, Xu, Xu, Xu, Qxua, Xu, Qxua, Qxua, Qxua, Qxua, Qxua, Uh^Emf, Xu, Re^Es, Re^Es, Xu, Xu, Uh^Em, Uh^Emf, Xu, Xu, Uh, Qxua, Gll^Fdw, Qxua, Qxua
Qxua, Xu, Qxua, Uh, Qxua, Qxua, Qxua, Xu, Xu, Qxua, Xu, Qxua, Qxua, Qxua, Qxua, Qxua, Qxua, Uh^Emf, Uh, Re^Em, Uh^Emf, Uu, Qxua, Xu, Qxua, Qxua, Qxua, Qxua, Qxua, Qxua, Qxua, Xu, Xu, Xu, Re, Qxua, Uu^Edb, Uh^Emf, Uh^Edb, Uu^Em, Uu^Em, Re^Es, Uu^Em, Uu^Em, Qxua, Uh^Emf, Uu^Edb, Uu, Qxua, Qxua, Qxua, Qxua, Qxua
Qxua, Qxua, Qxua, Qxua, Qxua, Qxua, Qxua, Qxua, Qxua, Qxua, Qxua, Qxua, Gll^Fdw, Qxua, Qxua, Qxua, Qxua, Qxua, Qxua, Qxua, Qxua, Qxua, Qxua, Xu, Qxua, Qxua, Xu, Qxua, Qxua, Gll^Fdw, Gll^Fdw, Xu, Re^Es, Re, Qxua, Re, Re, Uu^Edb, Qxua, Qxua, Qxua, Re^Es, Re^Es, Qxua, Uh^Edb, Uh^Edb, Qxua, Qxua, Gll^Fdw, Qxua, Qxua, Qxua, Qxua
Qxua, Qxua, Qxua, Qxua, Qxua, Qxua, Qxua, Qxua, Gll^Fdw, Qxua, Qxua, Qxua, Gll^Ve, Qxua, Xu, Xu, Qxua, Qxua, Gll^Fmw, Qxua, Gll^Fmw, Qxua, Xu, Xu, Xu, Qxua, Xu, Qxua, Qxua, Gll^Ve, Gll^Fmw, Qxua, Re^Es, Qxua, Qxua, Qxua, Qxua, Uu, Re^Ebn, Qxua, Uu, Qxua, Re, Qxua, Uh^Edb, Uh^Edb, Uu, Qxua, Qxua, Gll^Fdw, Qxua, Qxua, Qxua
Qxua, Qxua, Qxua, Qxua, Qxua, Qxua, Qxua, Qxua, Qxua, Qxua, Qxua, Qxua, Qxua, Qxua, Xu, Xu, Xu, Gll^Fmw, Gll^Fmw, Gll^Fmw, Qxua, Xu, Qxua, Xu, Xu, Xu, Qxua, Qxua, Cde, Gll^Fmw, Qxua, Gll^Fdw, Re^Es, Re, Uu, Qxua, Uu, Re, Re, Qxua, Qxua, Qxua, Re^Es, Qxua, Qxua, Qxua, Qxua, Uu^Edb, Qxua, Qxua, Qxua, Qxua, Qxua
Qxua, Qxua, Qxua, Qxua, Qxua, Qxua, Qxua, Qxua, Gll^Fdw, Qxua, Qxua, Qxua, Qxua, Qxua, Qxua, Gll^Fmw, Xu, Gll^Fmw, Xu, Xu, Qxua, Qxua, Qxua, Xu, Qxua, Qxua, Kde, Qxua, Qxua, Gll^Fdw, Re, Uu, Qxua, Qxua, Uh, Qxua, Re^Es, Re^Es, Qxua, Re, Re, Re^Es, Qxua, Qxua, Uh^Edb, Qxua, Uh^Edb, Uh^Edb, Xu, Qxua, Xu, Xu, Xu
Qxua, Qxua, Qxua, Qxua, Qxua, Qxua, Qxua, Gll^Fdw, Qxua, Qxua, Qxua, Qxua, Gll^Fdw, Qxua, Qxua, Qxua, Qxua, Xu, Xu, Xu, Xu, Qxua, Xu, Xu, Qxua, Cde, Cde, Cde, Gll^Fmw, Re, Qxua, Qxua, Uu, Uh^Emf, Qxua, Qxua, Re, Qxua, Uu, Qxua, Qxua, Qxua, Isa, Uu, Qxua, Uh^Edb, Qxua, Xu, Xu, Xu, Xu, Xu, Xu
Qxua, Qxua, Qxua, Qxua, Qxua, Qxua, Qxua, Gll^Fdw, Qxua, Qxua, Qxua, Qxua, Gll^Fmw, Gll^Fmw, Qxua, Qxua, Qxua, Qxua, Qxua, Qxua, Qxua, Xu, Qxua, Isa, Isa, Gll^Ve, Gll^Fdw, Gll^Fmw, Gll^Fdw, Re, Re, Gll^Es, Uu^Em, Uh^Em, Uu^Em, Re^Em, Re, Qxua, Qxua, Qxua, Qxua, Isa, Isa, Qxua, Uu, Qxua, Xu, Xu, Xu, Xu, Xu, Xu, Xu
Qxua, Qxua, Xu, Qxua, Xu, Qxua, Qxua, Gll^Fdw, Qxua, Qxua, Qxua, Gll^Fdw, Qxua, Qxua, Gll^Fmw, Qxua, Qxua, Qxua, Qxua, Qxua, Qxua, Qxua, Qxua, Isa, Isa, Uu, Uu, Gll^Fdw, Uu, Re, Re^Es, Uu^Es, Uu^Es, Qxua, Uh, Qxua, Uu^Edb, Uu^Edb, Isa^Edb, Isa^Edb, Isa^Edb, Isa, Xu, Qxua, Qxua, Qxua, Xu, Xu, Xu, Xu, Xu, Xu, Xu
Qxua, Qxua, Qxua, Xu, Xu, Qxua, Gll^Fdw, Gll^Fmw, Gll^Fmw, Qxua, Qxua, Qxua, Qxua, Qxua, Qxua, Qxua, Qxua, Qxua, Qxua, Qxua, Gll^Fdw, Qxua, Isa, Isa, Qxua, Qxua, Qxua, Uu, Re, Uu^Ebn, Re, Re^Es, Uh^Em, Uh, Qxua, Uu^Edb, Qxua, Qxua, Qxua, Isa^Edb, Qxua, Qxua, Xu, Uh, Qxua, Qxua, Xu, Xu, Xu, Xu, Xu, Xu, Xu
Qxua, Xu, Xu, Xu, Qxua, Qxua, Gll^Fdw, Qxua, Qxua, Gll^Fmw, Gll^Fmw, Qxua, Qxua, Qxua, Qxua, Qxua, Qxua, Qxua, Qxua, Qxua, Uu, Isa, Uu, Uu, Re^Edb, Re^Edb, Re^Edb, Re, Uu, Re, Gll^Es, Uu^Es, Uh^Emf, Qxua, Qxua, Uu, Re, Qxua, Qxua, Qxua, Uu^Em, Uh, Qxua, Xu, Xu, Xu, Xu, Xu, Xu, Xu, Xu, Xu, Xu
Qxua, Qxua, Isa, Uu, Gll^Fdw, Gll^Fmw, Gll^Fmw, Qxua, Qxua, Qxua, Gll^Ve, Gll^Fdw, Qxua, Qxua, Qxua, Qxua, Qxua, Qxua, Qxua, Qxua, Uu^Es, Isa, Uu, Qxua, Re^Edb, Re^Edb, Qxua, Qxua, Gll^Fdw, Gll^Fdw, Qxua, Gll^Fdw, Uh, Qxua, Qxua, Qxua, Re, Uu, Uu, Uu^Em, Xu, Uh^Emf, Qxua, Xu, Xu, Xu, Xu, Xu, Xu, Xu, Xu, Xu, Xu
Uu, Uu, Re^Es, Uu, Re, Gll^Fmw, Gll^Fdw, Isa, Qxua, Qxua, Qxua, Gll^Fmw, Qxua, Qxua, Qxua, Qxua, Qxua, Qxua, Uh, Uh, Re^Es, Re^Es, Uu, Re, Re, Qxua, Xu, Qxua, Xu, Qxua, Xu, Xu, Xu, Uu, Uu, Re, Xu, Re, Xu, Xu, Xu, Qxua, Xu, Xu, Xu, Xu, Xu, Xu, Xu, Xu, Xu, Xu, Xu
Re, Re^Es, Re^Es, Re^Es, Re^Es, Uu^Ebn, Uu, Isa, Isa, Qxua, Gll^Fmw, Gll^Fmw, Qxua, Qxua, Qxua, Uu, Qxua, Uu, Gll^Fdw, Uu^Edb, Re^Es, Re, Uu, Qxua, Qxua, Xu, Xu, Xu, Xu, Qxua, Xu, Xu, Xu, Qxua, Qxua, Qxua, Xu, Xu, Qxua, Xu, Xu, Xu, Xu, Xu, Xu, Xu, Xu, Xu, Xu, Xu, Xu, Xu, Xu
Uu, Re^Es, Uu, Uu, Re^Es, Re^Es, Re^Es, Uu, Gll^Fdw, Gll^Fdw, Gll^Fmw, Qxua, Qxua, Qxua, Qxua, Qxua, Qxua, Gll^Fdw, Re^Es, Re^Es, Re^Es, Uu^Ebn, Qxua, Qxua, Uu, Xu, Xu, Xu, Xu, Xu, Xu, Xu, Xu, Xu, Xu, Xu, Xot, Xu, Xu, Qxua, Xu, Qxua, Qxua, Xu, Xu, Xu, Xu, Xu, Xu, Xu, Xu, Xu, Xu
Qxua, Uu, Qxua, Qxua, Uh^Em, Re^Em, Re^Edb, Uu^Es, Uu, Gll^Fdw, Qxua, Qxua, Qxua, Qxua, Qxua, Qxua, Qxua, Gll^Fdw, Gll^Fdw, Re^Es, Re^Es, Uu, Uu, Qxua, Qxua, Qxua, Xu, Xu, Xot, Xot, Qxua, Xu, Qxua, Xu, Gll^Fdw, Gll^Fmw, Gll^Fmw, Xot, Qxua, Xu, Xu, Xu, Qxua, Xu, Xu, Xu, Xu, Xu, Xu, Xu, Xu, Xu, Xu
Qxua, Qxua, Qxua, Qxua, Uh^Emf, Uh^Edb, Uu^Edb, Re^Edb, Re, Qxua, Qxua, Uh, Uh^Emf, Qxua, Qxua, Qxua, Gll^Fmw, Qxua, Qxua, Gll^Fdw, Re^Es, Re^Es, Re, Qxua, Qxua, Xot, Xot, Xot, Xot, Xu, Qxua, Qxua, Qxua, Uh, Gll^Fdw, Gll^Ve, Gll^Fdw, Gll^Fmw, Gll^Em, Uh^Emf, Uh^Emf, Uh, Gll^Fdw, Xu, Xu, Xu, Xu, Xu, Xu, Xu, Xu, Xu, Xu
Qxua, Qxua, Qxua, Qxua, Gll^Fdw, Uh^Fdw, Qxua, Uu^Edb, Re^Edb, Uh, Uh^Em, Uh^Em, Uh, Qxua, Qxua, Qxua, Qxua, Qxua, Gll^Ve, Gll^Fmw, Qxua, Re, Uu, Qxua, Qxua, Qxua, Qxua, Qxua, Qxua, Qxua, Kde, Qxua, Qxua, Uh, Uu, Uu, Uu^Es, Gll^Fdw, Re, Re^Em, Re^Em, Gll^Fdw, Gll^Fdw, Uu, Xu, Xu, Xu, Xu, Xu, Xu, Xu, Xu, Xu
Qxua, Qxua, Qxua, Qxua, Gll^Fmw, Qxua, Gll^Fdw, Uu, Re, Uu, Gll^Fdw, Qxua, Qxua, Qxua, Qxua, Qxua, Gll^Fmw, Gll^Fmw, Qxua, Gll^Fmw, Gll^Fdw, Uu, Re, Uu, Uu, Qxua, Uu^Ebn, Qxua, Qxua, Cde, Re, Qxua, Uu, Uu, Re, Re, Re, Xu, Re, Re^Em, Re, Uu, Gll^Ve, Gll^Fdw, Qxua, Xu, Xu, Xu, Xu, Xu, Xu, Xu, Qxua
Qxua, Qxua, Qxua, Qxua, Gll^Fmw, Gll^Fmw, Qxua, Gll^Fmw, Re, Gll^Fmw, Gll^Fdw, Uh, Xu, Xu, Xu, Qxua, Qxua, Gll^Fmw, Qxua, Qxua, Gll^Fdw, Uh, Uh, Re, Re, Re, Uu^Es, Uh, Re^Es, Re, Re^Es, Re^Es, Uu, Uu, Xu, Uu^Ebn, Xu, Re, Xu, Xu, Xu, Re, Gll^Fdw, Qxua, Qxua, Xu, Xu, Xu, Xu, Xu, Xu, Xu, Qxua
Qxua, Qxua, Qxua, Qxua, Qxua, Gll^Fmw, Uu, Re, Re^Edb, Uu^Ebn, Re, Uu, Re^Em, Uh^Emf, Xu, Qxua, Qxua, Qxua, Qxua, Gll^Fmw, Gll^Fmw, Uh, Qxua, Uh, Re, Re, Re, Re^Es, Uu, Re^Es, Re, Uu, Kde, Xu, Xu, Xu, Xot, Xu, Xu, Xu, Xu, Qxua, Uu, Qxua, Qxua, Xu, Xu, Xu, Xu, Xu, Xu, Xu, Qxua
Qxua, Qxua, Qxua, Qxua, Qxua, Qxua, Xot, Re^Edb, Uu^Edb, Re, Xu, Xu, Re, Re^Em, Xot, Uh, Qxua, Qxua, Gll^Fmw, Qxua, Qxua, Qxua, Qxua, Qxua, Qxua, Uu, Qxua, Qxua, Xu, Uu, Xu, Uu, Cde, Cde, Xu, Xot, Xot, Uu^Edb, Re^Edb, Re^Edb, Uu, Uu, Gll^Fdw, Qxua, Qxua, Qxua, Qxua, Xu, Xu, Xu, Qxua, Qxua, Qxua
Qxua, Qxua, Qxua, Qxua, Qxua, Xu, Xot, Xot, Isa, Uu, Xot, Xot, Xu, Re^Es, Re, Xot, Xu, Qxua, Qxua, Qxua, Qxua, Qxua, Qxua, Qxua, Gll^Fdw, Qxua, Qxua, Xu, Qxua, Xu, Qxua, Cde, Xu, Cde, Xu, Xot, Re^Edb, Re^Edb, Xu, Uu^Edb, Gll^Fdw, Qxua, Gll^Fmw, Gll^Fmw, Qxua, Qxua, Qxua, Qxua, Qxua, Qxua, Qxua, Qxua, Qxua
Qxua, Qxua, Qxua, Qxua, Qxua, Qxua, Xu, Xu, Isa, Isa, Uu, Xot, Xu, Re^Es, Re^Es, Uu, Qxua, Qxua, Qxua, Qxua, Qxua, Qxua, Qxua, Qxua, Qxua, Gll^Fmw, Gll^Fmw, Qxua, Xu, Qxua, Xu, Xu, Xu, Xu, Xu, Xu, Uu, Re^Edb, Qxua, Gll^Fmw, Qxua, Gll^Fdw, Gll^Ve, Gll^Fmw, Qxua, Qxua, Qxua, Qxua, Qxua, Qxua, Qxua, Qxua, Qxua
Qxua, Qxua, Qxua, Qxua, Qxua, Qxua, Qxua, Xu, Xu, Isa, Xu, Uu, Uu, Uu, Re^Es, Re, Uu^Ebn, Cde, Cde, Qxua, Qxua, Qxua, Qxua, Qxua, Isa, Gll^Fdw, Uu, Qxua, Re^Edb, Xu, Re, Xu, Re, Uu^Ebn, Re, Xu, Qxua, Re, Qxua, Gll^Fmw, Qxua, Qxua, Gll^Fmw, Gll^Fmw, Gll^Fmw, Qxua, Qxua, Qxua, Qxua, Qxua, Qxua, Qxua, Qxua
Qxua, Qxua, Qxua, Qxua, Qxua, Qxua, Qxua, Xu, Xu, Xu, Xu, Gll^Fdw, Gll^Fdw, Gll^Fdw, Re, Uu, Uu, Qxua, Uh, Qxua, Uh, Qxua, Uu^Edb, Isa, Uu, Uu, Uu, Re^Es, Re^Es, Re^Es, Uu^Es, Re^Es, Qxua, Re, Qxua, Uu, Uu, Isa, Qxua, Qxua, Qxua, Qxua, Qxua, Gll^Fmw, Qxua, Qxua, Qxua, Qxua, Qxua, Qxua, Qxua, Qxua, Qxua
Qxua, Qxua, Qxua, Qxua, Qxua, Qxua, Qxua, Qxua, Qxua, Qxua, Qxua, Gll^Fdw, Gll^Fmw, Re^Edb, Re, Gll^Fdw, Re^Es, Uu, Re^Es, Uh^Emf, Uu^Em, Uu, Re^Edb, Uu^Edb, Qxua, Uh, Qxua, Qxua, Qxua, Qxua, Qxua, Qxua, Qxua, Qxua, Qxua, Qxua, Qxua, Qxua, Qxua, Qxua, Qxua, Qxua, Qxua, Qxua, Qxua, Qxua, Qxua, Qxua, Qxua, Qxua, Qxua, Qxua, Qxua
Qxua, Qxua, Qxua, Qxua, Qxua, Qxua, Gll^Fmw, Qxua, Qxua, Qxua, Gll^Fdw, Gll^Fdw, Gll^Ve, Gll^Fdw, Qxua, Re, Uu, Re^Em, Gll^Fdw, Gll^Fdw, Gll^Fdw, Uu^Edb, Gll^Fdw, Uu^Edb, Uh, Uh, Qxua, Gll^Fdw, Gll^Fdw, Qxua, Gll^Fdw, Qxua, Qxua, Qxua, Gll^Fdw, Qxua, Qxua, Qxua, Qxua, Qxua, Qxua, Qxua, Qxua, Qxua, Qxua, Qxua, Qxua, Qxua, Qxua, Qxua, Qxua, Qxua, Qxua
Qxua, Qxua, Qxua, Qxua, Qxua, Qxua, Qxua, Gll^Fmw, Gll^Fmw, Qxua, Gll^Fmw, Gll^Fdw, Gll^Fmw, Gll^Fdw, Qxua, Qxua, Qxua, Gll^Fdw, Gll^Fmw, Gll^Ve, Uu, Gll^Fdw, Gll^Fdw, Uu, Uh, Qxua, Qxua, Gll^Fmw, Gll^Fmw, Qxua, Qxua, Qxua, Qxua, Gll^Fdw, Qxua, Gll^Fdw, Qxua, Qxua, Qxua, Qxua, Qxua, Qxua, Qxua, Qxua, Qxua, Qxua, Qxua, Qxua, Qxua, Qxua, Qxua, Qxua, Qxua
Qxua, Qxua, Qxua, Qxua, Qxua, Qxua, Qxua, Qxua, Gll^Fmw, Qxua, Qxua, Qxua, Qxua, Gll^Fdw, Gll^Fdw, Gll^Fdw, Gll^Fdw, Gll^Fdw, Gll^Fmw, Qxua, Qxua, Gll^Fdw, Qxua, Qxua, Qxua, Qxua, Qxua, Qxua, Gll^Fmw, Gll^Fdw, Qxua, Qxua, Qxua, Qxua, Qxua, Qxua, Qxua, Qxua, Qxua, Qxua, Qxua, Qxua, Qxua, Qxua, Qxua, Qxua, Qxua, Qxua, Qxua, Qxua, Qxua, Qxua, Qxua
Qxua, Qxua, Qxua, Qxua, Qxua, Qxua, Qxua, Qxua, Qxua, Qxua, Qxua, Qxua, Qxua, Qxua, Qxua, Qxua, Qxua, Gll^Fmw, Qxua, Qxua, Qxua, Qxua, Qxua, Qxua, Qxua, Qxua, Qxua, Qxua, Qxua, Qxua, Qxua, Qxua, Qxua, Qxua, Qxua, Qxua, Qxua, Qxua, Qxua, Qxua, Qxua, Qxua, Qxua, Qxua, Qxua, Qxua, Qxua, Qxua, Qxua, Qxua, Qxua, Qxua, Qxua
Qxua, Qxua, Qxua, Qxua, Qxua, Qxua, Qxua, Qxua, Qxua, Qxua, Qxua, Qxua, Qxua, Qxua, Qxua, Qxua, Qxua, Qxua, Qxua, Qxua, Qxua, Qxua, Qxua, Qxua, Qxua, Qxua, Qxua, Qxua, Qxua, Qxua, Qxua, Qxua, Qxua, Qxua, Qxua, Qxua, Qxua, Qxua, Qxua, Qxua, Qxua, Qxua, Qxua, Qxua, Qxua, Qxua, Qxua, Qxua, Qxua, Qxua, Qxua, Qxua, Qxua
