Xu, Xu, Xu, Xu, Xu, Xu, Xu, Xu, Xu, Xu, Qxua, Qxua, Qxua, Xu, Xu, Xu, Qxua, Qxua, Xu, Xu, Xu, Xu, Xu, Xu, Xu, Xu, Xu, Ias, Xu, Xu, Xu, Xu, Xu, Xu, Qxua, Xu, Xu, Xu, Xu, Qxua, Xu, Xu
Qxua, Xu, Xu, Xu, Xu, Xu, Xu, Xu, Xu, Xu, Xu, Qxua, Qxua, Xu, Qxua, Qxua, Xu, Qxua, Xu, Xu, Xu, Xu, Xu, Xu, Xu, Xu, Xu, Xu, Xu, Qxua, Qxua, Xu, Xu, Xu, Qxua, Qxua, Qxua, Xu, Xu, Qxua, Qxua, Xu
Qxua, Xu, Xu, Xu, Xu, Xu, Xu, Xu, Xu, Gll^Fmw, Gll^Fmw, Xu, Qxua, Qxua, Gll^Fmw, Xu, Xu, Xoa, Xoa, Xu, Xoa, Xu, Xoa, Xoa, Qxua, Xu, Qxua, Xoa, Qxua, Qxua, Qxua, Xu, Xoa, Xu, Qxua, Qxua, Qxua, Qxua, Qxua, Qxua, Xu, Qxua
Xu, Qxua, Xu, Gll^Fmw, Xu, Xu, Qxua, Xoa, Gll^Fmw, Qxua, Qxua, Qxua, Qxua, Gll^Fmw, Gll^Fmw, Xu, Xu, Xoa, Xu, Xoa, Tb^Tf, Tb^Tf, Tb^Tf, Xu, Uh, Xoa, Xu, Qxua, Uh, Xoa, Xoa, Qxua, Tb^Tf, Qxua, Uh, Qxua, Xu, Xu, Xu, Qxua, Qxua, Qxua
Xu, Qxua, Gll^Fmw, Gll^Fmw, Xoa, Xu, Xoa, Qxua, Qxua, Qxua, Isa, Isa, Isa, Qxua, Qxua, Qxua, Xu, Xu, Uh, Tb^Tf, Uu^Vud, Tb^Tf, Isa, Uh, Uh, Isa, Isa, Uh, Isa, Isa, Isa, Tb^Tf, Uu^Vud, Qxua, Xu, Xu, Uh, Xu, Qxua, Qxua, Qxua, Xu
Xu, Qxua, Qxua, Qxua, Qxua, Xoa, Qxua, Qxua, Qxua, Qxua, Isa, Isa, Qxua, Qxua, Qxua, Isa, Isa, Uh, Isa, Uh, Xoa, Xoa, Xoa, Uh, Isa, Re, Isa, Isa, Re^Em, Re^Emf, Re^Emf, Isa, Qxua, Qxua, Qxua, Qxua, Qxua, Qxua, Qxua, Qxua, Gll^Fmw, Xu
Xu, Gll^Fmw, Qxua, Qxua, Xu, Qxua, Qxua, Qxua, Qxua, Qxua, Qxua, Isa, Isa, Uu^Vud, Isa, Xoa^Efs, Xoa^Efs, Isa, Isa, Isa, Xoa, Xoa, Xoa, Isa, Isa, Re, Xoa^Efs, Xoa^Efs, Re^Em, Re^Emf, Re^Em, Re^Emf, Isa, Qxua, Isa, Isa, Uu^Vud, Xoa, Xoa, Gll^Fmw, Gll^Fmw, Xu
Qxua, Gll^Fmw, Qxua, Xu, Xoa, Isa, Isa, Qxua, Uu^Vud, Qxua, Isa, Isa, Uu, Isa, Uu, Re, Re, Isa, Xoa^Efs, Xoa, Cud, Cud, Cud, Xoa, Xoa, Re, Re, Re, Re^Em, Re^Em, Re, Qxua, Qxua, Qxua, Isa, Isa, Isa, Uh, Tb^Tf, Xoa, Xu, Xu
Qxua, Qxua, Qxua, Qxua, Qxua, Qxua, Qxua, Qxua, Qxua, Isa, Uu^Emf, Uu^Emf, Uu^Em, Re, Re, Re, Xoa^Efs, Re, Re, Xoa^Efs, Cud, Kud, Cud, Xoa^Efs, Isa, Re, Xoa^Efs, Isa, Isa, Re^Es, Re, Isa, Isa, Qxua, Qxua^Bcx/, Isa, Isa, Uh, Uh, Tb^Tf, Tb^Tf, Isa
Xu, Qxua, Xu, Xoa, Xoa, Xoa, Qxua, Qxua, Isa, Qxua, Uu^Em, Uu^Es, Isa, Re, Xoa, Isa, Isa, Re, Isa, Isa, Isa, Cud, Isa, Isa, Isa, Isa, Isa, Isa, Xoa, Isa, Isa, Re, Isa, Isa, Isa, Qxua, Isa, Isa, Isa, Tb^Tf, Uu^Fdw, Uu
Uh, Xu, Xu, Xoa, Isa, Uu^Vud, Isa, Qxua, Isa, Isa, Isa, Uu, Isa, Xoa, Xoa, Xoa, Isa, Re, Isa, Isa, Isa, Isa, Isa, Isa, Isa, Isa, Isa, Xoa^Efs, Xoa, Xoa, Isa, Isa, Isa, Isa, Isa, Qxua^Bcx/, Qxua, Isa, Isa, Isa, Isa, Isa
Uh, Gll^Fmw, Uh, Tb^Tf, Isa, Isa, Isa, Qxua, Qxua, Isa, Isa, Re, Isa, Xoa^Efs, Xoa^Efs, Cud, Isa, Isa, Isa, Isa, Isa, 2 Isa, Isa, Isa, Isa, Isa, Isa, Cud, Xoa^Efs, Xoa^Efs, Isa, Re, Re^Fdw, Isa, Isa, Isa, Qxua, Isa, Xoa, Xu, Xu, Isa
Tb^Tf, Uh, Tb^Tf, Uh, Isa, Isa, Qxua^Bcx\, Qxua, Isa, Isa, Xoa, Isa, Isa, Isa, Isa, Isa, Isa, Isa, Re, Isa, Isa, Isa, Isa, Isa, Isa, Isa, Isa, Isa, Re, Isa, Re, Re^Es, Xoa, Isa, Isa, Qxua, Qxua, Qxua, Qxua, Xoa, Qxua, Qxua
Isa, Uh, Isa, Isa, Qxua, Qxua, Isa, Isa, Isa, Xoa^Efs, Xoa^Efs, Isa, Re^Es, Isa, Re^Es, Re, Re^Es, Re^Es, Isa, Isa, Isa, Isa, Isa, Isa, Isa, Isa, Isa, Isa, Isa, Re^Es, Re^Es, Re^Es, Xoa^Efs, Xoa^Efs, Uu^Emf, Isa, Qxua, Qxua, Xoa, Qxua, Xu, Xu
Isa, Isa, Isa, Isa, Qxua, Isa, Gll^Fmw, Isa, Gll^Fmw, Isa, Isa, Re, Re, Re^Es, Xoa^Efs, Re^Es, Re, Re^Es, Isa, Isa, Isa, Isa, Isa, Isa, Isa, Isa, Isa, Isa, Xoa^Efs, Isa, Isa, Re^Es, Re^Es, Uu^Emf, Uu^Emf, Isa, Isa, Isa, Gll^Fmw, Xoa, Xu, Xu
Gll^Fmw, Gll^Fmw, Gll^Fmw, Isa, Isa, Qxua, Qxua, Gll^Fmw, Qxua, Isa, Re, Isa, Isa, Xoa^Efs, Cud, Re, Re, Isa, Isa, Isa, Isa, Isa, Isa, Isa, Isa, Isa, Isa, Re, Cud, Xoa, Isa, Isa, Re, Re, Isa, Uu, Isa, Gll^Fmw, Gll^Fmw, Xu, 3 Isa, Isa
Xu, Xu, Xu, Xu, Xu, Isa, Qxua, Qxua, Gll^Fmw, Isa, Isa, Isa, Isa, Xoa^Efs, Xoa^Efs, Re, Isa, Re, Isa, Isa, Isa, Isa, Isa, Isa, Isa, Isa, Re, Re, Xoa^Efs, Xoa^Efs, Isa, Re, Isa, Isa, Qxua, Isa, Isa, Gll^Fmw, Isa, Isa, Xu, Isa
Qxua, Qxua, Qxua, Xu, Xu, Isa, Qxua, Qxua, Qxua, Isa, Xoa, Isa, Re, Re, Re^Es, Re, Re, Re, Re^Es, Re, Isa, Isa, Isa, Isa, Isa, Isa, Re^Es, Re, Re, Isa, Re, Re^Es, Xoa, Qxua, Qxua, Isa, Qxua, Isa, Isa, Gll^Fmw, Xoa, Xu
Qxua, Qxua, Qxua, Xu, Qxua, Qxua, Qxua, Isa, Qxua, Xoa^Efs, Xoa^Efs, Isa, Re, Re^Es, Isa, Re, Isa, Isa, Re^Es, Re, Isa, Isa, Isa, Isa, Isa, Re, Re, Isa, Isa, Re, Isa, Re^Es, Xoa^Efs, Xoa^Efs, Re^Es, Qxua, Isa, Qxua, Isa, Xoa, Isa, Xu
Qxua, Qxua, Qxua, Qxua, Isa, Isa, Qxua, Qxua, Qxua, Re, Qxua, Re, Isa, Isa, Xoa^Efs, Isa, Isa, Re, Re^Es, Re, Re^Es, Re, Re, Isa, Isa, Isa, Isa, Isa, Xoa^Efs, Isa, Isa, Re^Es, Re^Es, Isa, Re^Fdw, Re^Fdw, Gll^Fmw, Isa, Isa, Isa, Isa, Isa
Qxua, Qxua, Qxua, Xu, Isa^Fdw, Re, Isa, Isa, Isa, Qxua, Qxua, Qxua, Qxua, Xoa^Efs, Cud, Re, Isa, Re, Re^Es, Re^Es, Re, Re^Es, Re, Isa, Isa, Isa, Isa, Re, Cud, Xoa^Efs, Isa, Isa, Qxua, Re, Qxua, Gll^Fmw, Uu^Vud, Qxua, Isa, Re^Fdw, Isa, Isa
Qxua, Qxua, Xu, Isa, Uu^Fdw, Re^Fdw, Re^Es, Re, Qxua, Qxua, Qxua, Qxua, Uu^Vud, Xoa^Efs, Xoa^Efs, Re, Isa, Isa, Isa, Re^Es, Re^Es, Re^Es, Isa, Isa, Isa, Isa, Isa, Re, Xoa^Efs, Xoa, Isa, Isa, Isa, Isa, Qxua, Qxua, Qxua, Qxua, Qxua, Gll^Fmw, Isa, Isa
Qxua, Qxua, Qxua, Xu, Tb^Tf, Uu^Fdw, Uu, Isa, Qxua, Re, Xoa, Isa, Isa, Isa, Isa, Isa, Isa, Isa, Re, Re, Isa, Re, Re, Isa, Isa, Isa, Re, Re, Re^Es, Re^Es, Re^Es, Isa, Xoa, Isa, Re^Es, Qxua, Uu, Qxua, Qxua, Xu, Xu, Xu
Xu, Qxua, Qxua, Qxua, Qxua, Tb^Tf, Uu, Uu^Es, Uu, Xoa^Efs, Xoa^Efs, Isa, Isa, Isa, Isa, Isa, Isa, Isa, Re, Re, Re, Isa, Re, Isa, Isa, Re, Re, Re, Isa, Isa, Re, Re, Xoa^Efs, Xoa^Efs, Isa, Re^Fdw, Uu, Xu, Xu, Qxua, Qxua, Qxua
Xu, Xu, Xu, Xoa, Xoa, Tb^Tf, Xoa, Re, Re^Es, Re, Qxua, Isa, Isa, Isa, Xoa^Efs, Isa, Isa, Re^Es, Isa, Isa, Isa, Isa, Isa, Isa, Isa, Isa, Isa, Isa, Xoa^Efs, Isa, Isa, Isa, Isa, Isa, Re, Re, Qxua, Xu, Qxua, Qxua, Xu, Qxua
Tb^Tf, Xu, Xu, Xu, Xu, Xoa, Xoa, Tb^Tf, Re, Re, Qxua, Isa, Qxua, Xoa^Efs, Cud, Re, Re^Es, Re, Re, Isa, Isa, Isa, Isa, Isa, Isa, Isa, Isa, Re, Cud, Xoa^Efs, Isa, Isa, Isa, Isa, Isa, Re^Es, Isa, Qxua, Gll^Fmw, Xu, Gll^Fmw, Xu
Isa, Tb^Tf, Tb^Tf, Tb^Tf, Xoa, Xoa, Isa, Tb^Tf, Re, Qxua, Isa, Isa, Isa, Xoa^Efs, Xoa^Efs, Xoa^Efs, Tb^Tf, Re^Es, Re, Isa, Isa, Isa, Isa, Isa, Isa, Isa, Isa, Xoa^Efs, Xoa^Efs, Xoa^Efs, Isa, Isa, Isa, Isa, Isa, Re^Fdw, Re^Fdw, Gll^Fmw, Gll^Fmw, Gll^Fmw, Isa, Isa
Isa, Isa, Isa, Uh, Uu, Uh, Isa, Isa, Isa, Qxua, Qxua, Qxua, Qxua, Isa, Isa, Tb^Tf, Tb^Tf, Re^Es, Re, Isa, Isa, Isa, Re, Re, Isa, Isa, Isa, Isa, Isa, Isa, Re, Re, Isa, Isa, Isa, Isa, Qxua, Re^Fdw, Qxua, Re, Isa, Isa
Xu, Xoa, Uh, Tb^Tf, Isa, Isa, Xoa, Xoa, Xoa, Isa, Isa, Isa, Gll^Fmw, Isa, Isa, Re, Isa, Re, Isa, Re, Isa, Isa, Re^Es, Isa, Isa, Isa, Isa, Re, Re^Es, Re, Re, Isa, Isa, Isa, Xoa, Isa, Isa, Qxua, Qxua, Isa, Isa, Xu
Xu, Xoa, Isa, Isa, Isa, Isa, Xoa^Efs, Xoa, Xoa, Isa, Gll^Fmw, Gll^Fmw, Gll^Fmw, Uu, Isa, Xoa, Xoa^Efs, Isa, Isa, Isa, Isa, Isa, Re, Re^Es, Isa, Isa, Xoa^Efs, Xoa, Re, Re^Es, Isa, Re, Isa, Xoa, Xoa, Xoa, Isa, Qxua, Qxua, Xu, Gll^Fmw, Gll^Fmw
Xu, Xu, Qxua, Qxua, Qxua, Isa, Isa, Xoa^Efs, Isa, Isa, Isa, Uu^Emf, Uu^Vud, Isa, Isa, Xoa^Efs, Isa, Isa, Isa, Isa, Isa, Isa, Isa, Isa, Isa, Isa, Re, Xoa^Efs, Isa, Re, Isa, Isa, Isa, Xoa^Efs, Xoa^Efs, Xoa, Isa, Qxua, Qxua, Gll^Fmw, Xu, Xu
Qxua, Qxua, Xoa, Qxua, Qxua, Gll^Fmw, Isa, Isa, Gll^Fmw, Isa, Qxua, Qxua, Qxua, Qxua, Qxua, Isa, Qxua, Isa, Isa, Isa, Re, Isa, Isa, Isa, Isa, Isa, Isa, Isa, Isa, Isa, Isa, Isa, Uu^Vud, Uh, Uh, Isa, Uh^Emf, Xu, Xu, Xu, Xu, Xu
Qxua, Xu, Xu, Xoa, Qxua, Qxua, Qxua, Qxua, Qxua, Qxua, Qxua, Qxua, Isa, Qxua, Qxua, Isa, Uh, Qxua, Qxua, Isa, Re^Es, Re^Es, Re^Es, Isa, Isa, Isa, Isa, Isa, Xu, Qxua, Qxua, Tb^Tf, Qxua, Tb^Tf, Tb^Tf, Uh^Emf, Uh, Qxua, Qxua, Qxua, Qxua, Xu
Xu, Xu, Xu, Xoa, Qxua, Qxua, Qxua, Gll^Fmw, Qxua, Qxua, Xoa, Xoa, Uh, Isa, Isa, Qxua, Qxua, Uh, Qxua, Isa, Isa, Isa, Uu, Re, Isa, Isa, Uu^Vud, Uh, Xu, Qxua, Xoa, Xoa, Qxua, Xu, Xu, Xu, Xu, Qxua, Gll^Fmw, Gll^Fmw, Qxua, Qxua
Qxua, Xu, Xu, Uu^Emf, Uu^Emf, Qxua, Uu, Qxua, Qxua, Qxua, Xoa, Xu, Uh, Xoa, Uh, Uh, Qxua, Uu^Vud, Qxua, Uh, Tb^Emf, Uu, Re, Re, Qxua, Isa, Uh^Emf, Uh^Emf, Qxua, Xoa, Qxua, Qxua, Gll^Fmw, Qxua, Qxua, Xu, Xu, Qxua, Gll^Fmw, Qxua, Qxua, Qxua
Qxua, Qxua, Qxua, Qxua, Qxua, Uu^Emf, Xu, Xoa, Qxua, Xoa, Xoa, Xoa, Xoa, Xoa, Xu, Uh, Qxua, Qxua, Qxua, Tb^Tf, Tb^Tf, Uu, Re^Es, Re^Es, Uu, Qxua, Qxua, Xu, Qxua, Qxua, Xoa, Qxua, Qxua, Gll^Fmw, Xu, Qxua, Qxua, Qxua, Qxua, Qxua, Qxua, Xu
Qxua, Qxua, Qxua, Qxua, Qxua, Xu, Qxua, Qxua, Qxua, Qxua, Xu, Xoa, Xu, Xu, Uh, Isa, Qxua, Gll^Fmw, Qxua, Qxua, Gll^Fdw, Uu^Fdw, 1 Uu, Re, Re, Isa, Qxua, Qxua, Qxua, Qxua, Xoa, Xu, Xu, Xu, Qxua, Qxua, Qxua, Qxua, Qxua, Qxua, Xu, Xu
Qxua, Qxua, Qxua, Qxua, Xu, Qxua, Qxua, Qxua, Qxua, Qxua, Xu, Xu, Xu, Xu, Qxua, Qxua, Qxua, Qxua, Qxua, Qxua, Gll^Fdw, Gll^Fdw, Re^Es, Re^Es, Re, Uu, Xu, Xu, Xu, Xoa, Xu, Xoa, Qxua, Qxua, Qxua, Qxua, Qxua, Qxua, Qxua, Qxua, Xu, Xu
Xu, Qxua, Qxua, Qxua, Xu, Qxua, Qxua, Qxua, Xu, Xu, Xu, Xu, Xu, Qxua, Isa, Qxua, Isa, Isa, Isa, Isa^Fdw, Isa, Isa, Isa, Uu^Fdw, Isa, Isa, Xu, Xu, Xu, Xu, Xu, Xu, Qxua, Qxua, Qxua, Qxua, Qxua, Qxua, Qxua, Qxua, Xu, Xu
